++LAYOUT++
 0 0 0 0 0 0 0 0 0 0 0 0 0 0 0 - 0 0 0 0 0 0 0 0 0 0 0 0 0 0 0
 0 1 0 2 0 1 0 2 0 1 0 2 0 1 0 - 0 1 0 2 0 1 0 2 0 1 0 2 0 1 0
 0 0 0 0 0 0 0 0 0 0 0 0 0 0 0 - 0 0 0 0 0 0 0 0 0 0 0 0 0 0 0
 0 2 0 1 0 2 0 1 0 2 0 1 0 2 0 - 0 2 0 1 0 2 0 1 0 2 0 1 0 2 0
 0 0 0 0 0 0 0 0 0 0 0 0 0 0 0 0 0 0 0 0 0 0 0 0 0 0 0 0 0 0 0
 0 1 0 2 0 1 0 2 0 1 0 2 0 1 0 - 0 1 0 2 0 1 0 2 0 1 0 2 0 1 0
 0 0 0 0 0 0 0 0 0 0 0 0 0 0 0 - 0 0 0 0 0 0 0 0 0 0 0 0 0 0 0
 - - - - 0 - - - - - 0 - - - - - - - - - 0 - - - - - 0 - - - -
 0 0 0 0 0 0 0 0 0 0 0 0 0 0 0 - 0 0 0 0 0 0 0 0 0 0 0 0 0 0 0
 0 2 0 1 0 2 0 1 0 2 0 1 0 2 0 - 0 2 0 1 0 2 0 1 0 2 0 1 0 2 0
 0 0 0 0 0 0 0 0 0 0 0 0 0 0 0 0 0 0 0 0 0 0 0 0 0 0 0 0 0 0 0
 0 1 0 2 0 1 0 2 0 1 0 2 0 1 0 - 0 1 0 2 0 1 0 2 0 1 0 2 0 1 0
 0 0 0 0 0 0 0 0 0 0 0 0 0 0 0 - 0 0 0 0 0 0 0 0 0 0 0 0 0 0 0
 0 2 0 1 0 2 0 1 0 2 0 1 0 2 0 - 0 2 0 1 0 2 0 1 0 2 0 1 0 2 0
++END++
++PLACEMENTS++
 0 0 0 0 0 0 0 0 0 0 0 0 0 0 0 - 0 0 0 0 0 0 0 0 0 0 0 0 0 0 0
 0 1 0 2 0 1 0 2 0 1 0 2 0 1 0 - 0 1 0 2 0 1 0 2 0 1 0 2 0 1 0
 I 0 0 0 E 0 0 0 0 0 0 0 0 0 0 0 0 0 0 0 0 0 0 0 0 0 0 0 0 0 0
 0 2 0 1 0 2 0 1 0 L 0 1 0 2 0 - 0 2 0 1 0 2 0 1 0 2 0 1 O 2 0
 0 0 0 0 0 0 0 0 0 0 0 0 0 0 0 0 0 0 0 0 0 0 0 0 0 0 E 0 0 0 0
 0 1 0 2 0 1 0 2 0 1 0 2 0 1 0 - 0 1 0 2 0 1 0 2 0 1 0 2 0 1 0
 0 0 0 0 0 0 0 0 0 0 0 0 0 0 0 - 0 0 0 0 0 0 0 0 0 0 0 0 0 0 0
 - - - - 0 - - - - - 0 - - - - - - - - - 0 - - - - - 0 - - - -
 0 0 0 0 0 0 0 0 0 0 0 0 0 0 0 - 0 0 0 0 0 0 0 0 0 0 0 0 0 0 0
 0 2 0 1 0 2 0 1 0 2 0 1 0 2 0 - 0 2 0 1 0 2 0 1 0 2 0 1 0 2 0
 0 0 0 0 0 0 0 0 0 0 E 0 0 0 0 0 0 0 0 0 0 0 0 0 0 0 0 0 0 0 0
 0 1 0 L 0 1 0 2 0 1 0 2 0 1 0 - 0 1 0 2 0 1 0 2 0 1 0 2 P 1 0
 0 0 0 0 0 0 0 0 0 0 0 0 0 0 0 0 0 0 0 0 E 0 0 0 0 0 0 0 0 0 0
 0 2 0 1 0 2 0 1 0 2 0 1 0 2 0 - 0 2 0 1 0 2 0 1 0 2 0 1 0 2 0
++END++
++PATROL ROUTES++
4,2-20,2-20,10-4,10
26,4-26,12-10,12-10,4
20,12-4,12-4,4-20,4
10,10-10,2-26,2-26,10
++END++
++LOOT VALUES++
9,3-20
11,3-20
28,3-65
++END++
++ENDFILE++
