++LAYOUT++
0 0 0 0 0 0 0 0 0 0 0 0 0 - - - 0 0 0 0 0 0 0 0 0 0 0 0 0
0 1 1 1 1 2 2 2 2 0 0 0 0 - 3 - 0 0 0 0 0 0 0 0 0 0 0 0 0
0 1 1 1 0 2 2 2 2 0 0 0 0 - - - 0 0 0 0 2 2 2 2 2 2 2 0 0
0 1 1 1 0 2 2 2 2 3 3 3 3 3 3 3 3 3 3 3 2 2 2 2 2 2 2 0 0
0 0 0 0 0 0 0 1 0 0 2 0 0 - - - 0 0 0 0 0 0 2 0 0 0 0 0 0
0 0 0 0 0 0 0 1 1 1 2 1 1 1 1 1 1 1 1 2 2 2 2 0 3 3 3 3 3
0 0 0 0 0 0 0 1 0 0 2 2 0 - - - 0 0 0 2 2 2 2 0 3 3 3 3 3
0 0 0 1 1 1 1 1 0 0 2 2 0 - 3 - 0 0 0 2 2 2 2 0 3 3 3 3 3
0 0 0 1 1 1 1 1 1 2 2 2 0 - - - 0 0 0 0 2 0 0 0 0 2 0 0 0
0 0 0 0 1 0 0 0 0 0 0 0 0 - 3 - 0 0 0 3 3 3 0 0 2 2 2 2 0
0 0 0 0 1 0 0 3 3 3 0 0 0 - - - 0 0 0 3 3 3 0 0 1 1 1 1 0
0 0 0 0 2 2 2 3 3 3 3 3 3 3 3 3 3 3 3 3 3 3 0 0 1 1 1 1 0
0 0 0 0 0 0 0 3 3 3 0 0 0 - - - 0 0 0 0 2 0 0 0 1 0 0 0 0
0 0 0 0 0 0 0 0 0 0 0 0 0 - - - 0 0 0 2 2 2 2 2 2 0 0 0 0
0 0 0 0 0 0 0 0 0 0 0 0 0 - - - 0 0 0 2 2 2 2 2 2 0 0 0 0
++END++
++PLACEMENTS++
0 0 0 0 0 0 0 0 0 0 0 0 0 - - - 0 0 0 0 0 0 0 0 0 0 0 0 0
0 1 1 1 R 2 2 2 2 0 0 0 0 - U - 0 0 0 0 0 0 0 0 0 0 0 0 0
0 1 1 1 E 2 2 2 2 0 0 0 0 - - - 0 0 0 0 2 2 2 2 2 2 2 0 0
0 1 1 1 0 2 2 2 R 3 3 3 3 3 3 3 3 3 3 3 R 2 2 2 2 2 P 0 0
0 R 0 0 0 0 0 R 0 0 2 0 0 - - - 0 0 0 0 0 0 2 0 0 0 0 0 0
0 0 0 0 0 0 0 1 1 R 2 R 1 1 1 1 1 1 R 2 2 2 2 0 3 3 3 3 0
0 0 0 0 0 R 0 1 0 0 2 2 0 - - - 0 0 0 2 2 2 2 0 E 3 O 3 0
I 0 0 1 1 1 1 1 0 0 2 2 0 - U - 0 0 0 2 2 2 2 0 3 3 3 3 0
0 0 0 1 1 1 1 1 R 2 E 2 0 - - - 0 0 0 0 R 0 0 0 0 R 0 0 0
0 0 0 0 1 0 0 0 0 0 0 0 0 - U - 0 0 0 3 3 3 0 0 2 2 2 2 0
0 0 0 0 R 0 0 3 3 3 0 0 0 - - - 0 0 0 3 3 3 0 0 R 1 1 R 0
0 0 0 0 2 2 R 3 3 3 3 3 3 3 3 3 3 3 3 3 3 3 0 0 1 1 1 1 0
0 0 0 0 0 0 0 3 3 3 0 0 0 - - - 0 0 0 0 R 0 0 0 R 0 R 0 0
0 0 0 0 0 0 0 0 0 0 0 0 0 - - - 0 0 0 2 E 2 2 2 2 0 0 0 0
0 0 0 0 0 0 0 0 0 0 0 0 0 - - - 0 0 0 2 2 2 2 2 2 0 0 0 L
++END++
++PATROL ROUTES++
4,2-2,8-5,15-2,8
10,8-10,3-16,3-10,3
20,13-20,6
24,6-24,13
++END++
++LOOT VALUES++
26,6-70
28,14-20
9,9-15
3,14-10
14,10-15
++END++
++ENDFILE++
