++LAYOUT++
 0 0 0 0 0 0 0 0 0 0 0 0 0 0 0 0 0 0 0 0 0 0
 0 2 2 2 2 2 2 2 2 0 0 0 3 3 0 3 3 0 0 0 0 0
 0 2 0 0 0 0 0 0 2 0 0 0 3 0 0 0 3 0 0 0 0 0
 0 2 0 0 0 0 0 0 0 0 0 0 3 0 0 0 0 0 0 0 0 0
 0 2 0 0 0 0 0 0 2 0 0 0 3 0 0 0 3 0 0 0 0 0
 0 2 2 2 0 2 2 2 2 0 0 0 3 3 3 3 3 0 0 0 0 0
 0 0 0 0 0 0 0 0 0 0 0 0 0 0 0 0 0 0 0 0 0 0
 0 0 0 0 0 0 0 0 0 0 0 0 0 0 0 0 0 0 0 0 0 0
 0 0 3 3 3 3 2 2 0 2 2 0 0 0 0 0 0 0 0 0 0 0
 0 0 3 0 0 3 0 0 0 0 2 0 0 2 2 2 0 2 2 2 0 0
 0 0 0 0 0 3 0 0 0 0 2 0 0 2 0 0 0 0 0 2 0 0
 0 0 3 0 0 3 0 0 0 0 2 0 0 2 0 0 0 0 0 2 0 0
 0 0 3 3 0 3 0 0 0 0 2 0 0 0 0 0 0 0 0 2 0 0
 0 0 2 0 0 0 0 0 0 0 0 0 0 2 2 2 2 0 0 2 0 0
 0 0 2 0 0 0 0 0 0 0 2 0 0 0 0 0 2 0 0 2 0 0
 0 0 2 2 2 2 2 2 2 2 2 0 0 0 0 0 2 0 0 2 0 0
 0 0 0 0 0 0 0 0 0 0 0 0 0 0 0 0 2 2 0 2 0 0
 0 0 0 0 0 0 0 0 0 0 0 0 0 0 0 0 0 0 0 0 0 0
++END++
++PLACEMENTS++
 0 0 0 0 0 0 0 0 0 0 0 0 0 0 0 0 0 0 0 0 0 0
 0 2 2 2 2 2 2 2 2 0 0 0 3 3 0 3 3 0 0 0 0 0
 0 2 L 0 0 0 0 0 2 0 0 0 3 0 0 0 3 0 0 0 0 0
 0 2 0 0 E 0 0 0 0 0 0 0 3 0 0 0 0 0 0 0 0 0
 0 2 0 0 0 0 0 0 2 0 0 0 3 O 0 0 3 0 0 0 0 0
 0 2 2 2 0 2 2 2 2 0 0 0 3 3 3 3 3 0 0 0 0 0
 0 0 0 0 0 0 0 0 0 0 0 0 0 0 0 0 0 0 0 0 0 0
 0 0 0 0 0 0 0 0 0 0 0 0 0 0 0 0 0 0 0 0 0 0
 0 0 3 3 3 3 2 2 0 2 2 0 0 0 0 0 0 0 0 0 0 0
 I 0 3 0 0 3 0 0 0 L 2 0 0 2 2 2 0 2 2 2 0 0
 0 0 0 0 0 3 0 0 0 0 2 0 0 2 L 0 0 0 0 2 0 0
 0 0 3 0 0 3 0 0 0 0 2 0 0 2 0 0 0 0 0 2 0 0
 0 0 3 3 0 3 0 0 0 0 2 0 0 0 0 0 0 0 0 2 0 0
 0 0 2 0 0 0 0 0 0 0 E 0 0 2 2 2 2 0 0 2 0 0
 0 0 2 L 0 0 0 0 0 0 2 0 0 0 0 0 2 0 0 2 0 0
 0 0 2 2 2 2 2 2 2 2 2 0 0 0 0 0 2 P 0 2 0 0
 0 0 0 0 0 0 0 0 0 0 0 0 0 0 0 0 2 2 0 2 0 0
 0 0 0 0 0 0 0 0 0 0 0 E 0 0 0 0 0 0 E 0 0 0
++END++
++PATROL ROUTES++
4,3-10,3-16,0-18,7-11,7-4,7
10,13-4,10-2,13-7,16-12,17-20,15-12,7
11,17-11,9-11,0-14,3-18,7-20,13-20,17
18,17-18,11-16,8-19,0-10,0-10,9-18,9
++END++
++LOOT VALUES++
2,2-20
13,4-55
9,9-15
3,14-10
14,10-15
++END++
++ENDFILE++
