++LAYOUT++
0 0 0 0 0 0 0 0 0 0 0 0 2 2 2 2 0 0 0
0 0 0 0 0 0 0 0 0 0 0 0 0 0 0 2 0 0 0
0 0 1 1 1 1 0 0 0 0 2 2 2 2 2 2 2 0 0
0 0 1 0 0 0 0 0 0 0 0 0 0 0 0 0 2 0 0
0 0 1 0 0 0 0 0 0 0 0 0 0 0 0 0 2 0 0
0 0 1 0 0 2 2 2 0 0 1 1 1 2 0 0 0 0 0
0 0 1 0 0 2 3 2 3 3 3 3 3 2 0 2 0 0 0
0 0 0 0 0 1 3 2 2 2 2 2 2 2 0 2 0 0 0
0 2 2 2 0 1 3 2 2 2 2 2 3 0 0 2 2 2 2
0 0 0 2 0 1 3 2 2 2 2 2 3 0 0 0 0 0 0
0 0 0 2 0 0 3 2 2 2 2 2 3 0 0 0 0 0 0
0 0 0 0 0 0 3 3 3 2 3 3 3 1 0 0 1 0 0
0 0 2 2 2 0 0 0 0 2 2 2 1 1 0 0 1 0 0
0 0 0 0 2 0 0 0 0 0 0 0 0 0 0 0 1 0 0
0 0 0 0 2 0 0 0 0 0 0 0 0 1 1 1 1 1 0
0 0 2 2 2 2 2 2 2 0 0 2 0 1 0 0 0 0 0
0 0 0 0 0 0 0 0 0 0 0 2 0 1 1 1 0 0 0
0 0 0 0 0 0 0 2 2 2 2 2 0 0 0 0 0 0 0
++END++
++PLACEMENTS++
0 0 0 0 0 0 0 0 0 0 0 0 2 2 2 2 0 0 0
0 0 0 T 0 0 0 0 0 0 0 0 0 0 T 2 0 0 0
0 0 1 1 1 1 0 0 0 0 2 2 2 2 2 2 2 0 0
0 0 1 0 0 0 0 0 E 0 0 0 0 0 0 0 2 0 0
0 0 1 0 0 0 0 0 0 0 0 0 0 0 0 0 2 0 0
0 0 1 0 0 2 2 2 0 R 1 1 R 2 0 0 0 0 0
0 0 1 0 0 2 U 2 3 3 3 3 U 2 0 2 0 0 0
I 0 0 0 0 R 3 E 2 2 2 2 2 2 0 2 L 0 0
0 2 2 2 0 1 3 2 2 O 2 2 3 0 0 2 2 2 2
0 0 0 2 0 1 3 2 2 P 2 2 3 0 0 0 0 0 0
0 0 0 2 0 R 3 2 2 2 2 E 3 R 0 0 E 0 0
0 0 0 0 0 0 U 3 3 2 3 3 U 1 0 0 1 0 0
0 0 2 2 2 0 0 0 0 2 2 2 R 1 0 0 1 0 0
0 0 0 T 2 0 0 0 0 0 0 0 0 0 0 0 1 L 0
0 0 0 0 2 0 0 0 0 0 0 0 0 1 1 1 1 1 0
0 0 2 2 2 2 2 2 2 0 0 2 0 1 T 0 0 0 0
0 0 0 0 0 0 0 0 0 0 0 2 0 1 1 1 0 0 0
0 0 0 0 0 0 0 2 2 2 2 2 0 0 0 0 0 0 0
++END++
++PATROL ROUTES++
8,3-4,0-1,5-3,4
16,10-18,17-12,16-6,16-1,13-5,11-10,13
7,7-11,7-11,11-7,11
11,11-7,11-7,7-11,7
++END++
++LOOT VALUES++
16,7-15
17,13-20
9,8-65
++END++
++TERMINAL ASSIGNMENTS++
3,1-12,12
14,1-6,12
3,13-12,6
14,15-6,6
++END++
++ENDFILE++
