++LAYOUT++
0 0 0 0 0 0 0 2 2 0 0 - - - 0 0 0 0 0 0 0 0 0 0 0
0 0 0 0 0 0 0 2 0 0 0 - - - 0 0 1 0 0 0 0 2 2 2 0
0 0 1 1 1 1 0 2 0 2 2 - - 2 0 0 1 0 0 0 0 2 0 2 0
0 0 1 0 0 0 0 2 0 0 1 1 1 1 1 0 1 0 0 1 0 2 0 2 0
0 0 1 0 1 1 0 0 0 0 0 - - 2 0 0 1 1 1 1 0 2 0 0 0
0 0 1 1 1 0 0 1 1 1 0 - - - 0 0 0 0 0 0 0 0 0 0 0
0 0 0 0 0 0 0 1 0 1 0 - - - - - - - - - - - - - -
0 0 0 0 0 0 1 1 0 0 0 - - - 0 0 0 2 2 2 2 0 0 0 0
0 2 2 2 2 0 0 0 0 0 0 - - 2 0 0 0 2 0 0 2 0 0 0 0
0 2 0 0 2 0 0 1 0 0 1 1 1 1 1 0 0 2 0 0 2 2 0 1 0
0 0 0 0 2 0 0 1 0 0 0 - - 2 0 0 0 2 0 0 0 0 0 1 0
0 0 0 0 2 2 0 1 0 1 0 - - - 0 0 0 0 0 1 1 1 1 1 0
0 0 0 0 0 0 0 1 1 1 0 - - - 0 0 0 0 0 0 0 0 0 0 0
++END++
++PLACEMENTS++
0 0 0 0 0 0 0 2 2 0 0 - - - 0 0 0 0 0 0 E 0 0 0 0
0 0 0 0 0 0 0 2 0 0 0 - - - 0 0 1 0 0 0 0 2 2 2 0
0 0 1 1 1 1 0 2 0 2 2 - - U 0 0 1 0 0 0 0 2 O 2 0
0 0 1 0 0 0 0 2 0 R 1 1 1 1 1 R 1 P 0 1 0 2 0 2 0
0 0 1 T 1 1 0 0 0 0 E - - U 0 0 1 1 1 1 0 2 0 0 0
I 0 1 1 1 0 0 1 1 1 0 - - - 0 0 0 0 0 0 0 0 0 0 0
0 0 0 0 0 0 0 1 0 1 0 - - - - - - - - - - - - - -
0 0 0 0 0 0 1 1 0 0 0 - - - 0 0 0 2 2 2 2 0 0 0 0
0 2 2 2 2 0 0 0 0 0 0 - - U 0 0 0 2 0 T 2 0 0 E 0
0 2 L 0 2 0 0 1 0 R 1 1 1 1 1 R 0 2 0 0 2 2 0 1 0
E 0 0 0 2 0 0 1 0 0 0 - - U 0 0 0 2 0 0 0 0 0 1 L
0 0 0 0 2 2 0 1 0 1 0 - - - 0 0 0 0 0 1 1 1 1 1 0
0 0 0 0 0 0 0 1 1 1 0 - - - 0 0 0 0 0 0 0 0 0 0 0
++END++
++PATROL ROUTES++
10,4-10,8-5,8-5,5
0,10-0,6-6,6-6,1-1,1-1,7-5,7-6,12
23,8-24,12-18,12-22,10
20,0-20,5-24,5-24,0
++END++
++LOOT VALUES++
2,9-15
24,10-20
22,2-70
++END++
++TERMINAL ASSIGNMENTS++
3,4-13,8-13,10
19,8-13,2-13,4
++END++
++ENDFILE++
