++LAYOUT++
2 2 2 2 2 2 2 2 0 0 0 0 0
2 2 1 1 0 0 1 1 0 0 0 0 0
2 2 1 1 0 0 1 1 0 0 0 0 0
2 2 1 1 1 3 3 3 3 1 1 2 2
2 2 1 1 1 3 3 3 3 1 1 2 2
0 0 0 1 1 3 3 3 3 0 0 2 2
0 0 0 1 1 0 0 0 0 0 0 2 2
0 0 0 1 1 1 1 1 1 1 1 2 2
0 0 0 1 1 1 1 1 1 1 1 2 2
0 0 0 1 1 3 3 3 3 0 0 0 0
0 0 0 0 0 3 3 3 3 0 0 0 0
0 0 0 0 0 3 3 3 3 0 0 0 0
++END++
++PLACEMENTS++
2 2 2 2 2 2 2 X 0 0 0 0 0
2 2 1 1 R 0 R R 0 E 0 0 0
2 2 R 1 0 0 1 1 R 0 R 0 0
2 2 R 1 1 3 3 3 3 1 1 2 X
2 2 1 1 1 3 L 3 3 1 R 2 2
0 0 0 1 1 3 3 3 3 R 0 2 2
0 0 0 1 1 R 0 0 0 0 0 2 2
0 0 0 1 1 0 0 0 1 1 R 2 2
I 0 R 1 E 1 1 1 1 1   2 2
0 0 R 1 1 3 3 3 3 R R 0 0
0 0 0 0 0 3 3 L 3 0 0 0 0
0 0 0 0 0 3 3 3 3 0 0 0 0
++END++
++PATROL ROUTES++
4,8-4,3-4,0-7,2-9,2-11,5-7,8
9,2-11,5-7,8-4,8-4,3-4,0-7,2
++END++
++LOOT VALUES++
6,4-15
7,10-15
++END++
++ENDFILE++
