++LAYOUT++
 0 0 0 0 0 0 0 0 0 0 0 0 0 0 0
 0 1 0 2 0 1 0 2 0 1 0 2 0 1 0
 0 0 0 0 0 0 0 0 0 0 0 0 0 0 0
 0 2 0 1 0 2 0 1 0 2 0 1 0 2 0
 0 0 0 0 0 0 0 0 0 0 0 0 0 0 0
 0 1 0 2 0 1 0 2 0 1 0 2 0 1 0
 0 0 0 0 0 0 0 0 0 0 0 0 0 0 0
 0 2 0 1 0 2 0 1 0 2 0 1 0 2 0
 0 0 0 0 0 0 0 0 0 0 0 0 0 0 0
 0 1 0 2 0 1 0 2 0 1 0 2 0 1 0
 0 0 0 0 0 0 0 0 0 0 0 0 0 0 0
 0 2 0 1 0 2 0 1 0 2 0 1 0 2 0
 0 0 0 0 0 0 0 0 0 0 0 0 0 0 0
 0 1 0 2 0 1 0 2 0 1 0 2 0 1 0
 0 0 0 0 0 0 0 0 0 0 0 0 0 0 0
++END++
++PLACEMENTS++
 0 0 0 0 0 X 0 0 0 0 0 0 0 0 0
 0 1 0 2 0 1 0 2 0 1 0 2 0 1 0
 0 0 E 0 0 0 0 0 0 0 0 0 E 0 0
 0 2 0 1 0 2 0 1 0 2 0 1 0 2 0
 0 0 0 0 0 0 0 0 0 0 0 0 0 0 0
 0 1 0 2 0 1 0 2 0 1 0 2 0 1 0
 0 0 0 0 0 0 0 0 0 0 0 0 0 0 0
 I 2 0 1 0 2 0 1 0 2 0 1 0 2 0
 0 0 0 0 0 0 0 0 0 0 0 0 0 0 0
 0 1 0 2 0 1 0 2 0 1 0 2 0 1 X
 0 0 0 0 0 0 0 0 0 0 0 0 0 0 0
 0 2 0 1 0 2 0 1 0 2 0 1 0 2 0
 0 0 E 0 0 0 0 0 0 0 0 0 E 0 0
 0 1 0 2 0 1 0 2 0 1 0 2 0 1 0
 0 0 0 0 0 X 0 0 0 0 0 0 0 0 0
++END++
++PATROL ROUTES++
2,2-8,2-8,8-2,8
10,2-10,8-4,8-4,2
10,10-4,10-4,4-10,4
2,10-2,4-8,4-8,10
++END++
++LOOT VALUES++
5,7-15
9,7-15
++END++
++ENDFILE++
