++LAYOUT++
0 0 0 0 0 0 0 0 0 0 0 0 0 0 0
0 1 0 2 0 1 0 2 0 1 0 2 0 1 0
0 0 0 0 0 0 0 0 0 0 0 0 0 0 0
0 2 0 1 0 2 0 1 0 2 0 1 0 2 0
0 0 0 0 0 0 0 0 0 0 0 0 0 0 0
0 1 0 2 1 1 0 2 0 1 1 2 0 1 0
0 0 0 0 1 0 0 0 0 0 1 0 0 0 0
0 2 0 1 2 2 0 1 0 2 2 1 0 2 0
- - - - 2 - - - - - 2 - - - -
- - - - 3 - - - - - 3 - - - -
- - - - 2 - - - - - 2 - - - -
- - - - 2 - - - - - 2 - - - -
0 0 0 0 1 0 0 0 0 0 1 0 0 0 0
0 1 0 2 1 1 0 2 0 1 1 2 0 1 0
0 0 0 0 0 0 0 0 0 0 0 0 0 0 0
0 2 0 1 0 2 0 1 0 2 0 1 0 2 0
0 0 0 0 0 0 0 0 0 0 0 0 0 0 0
0 1 0 2 0 1 0 2 0 1 0 2 0 1 0
0 0 0 0 0 0 0 0 0 0 0 0 0 0 0
++END++
++PLACEMENTS++
0 0 0 0 0 0 0 0 0 0 0 0 0 L 0
0 1 0 2 0 1 0 2 0 1 0 2 0 1 0
0 0 0 0 0 0 0 0 0 0 E 0 0 0 0
I 2 0 1 0 2 0 1 0 2 0 1 0 2 0
0 0 0 0 R 0 0 0 0 0 R 0 0 0 0
0 1 0 2 1 1 0 2 0 1 1 2 0 1 0
0 0 0 0 R 0 0 0 0 0 R 0 0 0 0
0 2 0 1 2 2 0 1 0 2 2 1 0 2 0
- - - - R - - - - - R - - - -
- - - - 3 - - - - - 3 - - - -
- - - - R - - - - - R - - - -
- - - - 2 - - - - - 2 - - - -
0 0 0 0 R 0 0 0 0 0 R 0 0 0 0
0 1 0 2 1 1 0 2 0 1 1 2 0 1 0
0 0 0 0 R 0 0 0 0 0 R 0 0 0 0
0 2 0 1 0 2 0 1 0 2 0 1 0 2 X
0 0 0 0 E 0 0 0 0 0 0 0 0 0 0
0 1 0 2 0 1 0 2 0 1 0 2 0 1 0
0 L 0 0 0 0 0 0 0 0 0 0 0 0 0
++END++
++PATROL ROUTES++
4,16-2,16-2,18-12,18-12,16-10,16-10,9-10,2-12,2-12,0-2,0-2,2-4,2-4,9
10,2-12,2-12,0-2,0-2,2-4,2-4,9-4,16-2,16-2,18-12,18-12,16-10,16-10,9
++END++
++LOOT VALUES++
13,0-20
1,18-20
++END++
++ENDFILE++
