++LAYOUT++
0 0 0 0 0 0 0 0 0 0 0 0 0 0 0 0 0
0 0 0 0 0 0 0 0 0 0 0 0 0 0 0 0 0
0 0 0 - - - - - - - - 0 - - - - -
0 0 0 - 2 1 2 1 2 1 2 0 2 1 2 1 2
0 0 0 - 1 1 1 1 1 1 0 0 0 1 1 1 1
0 0 0 - 2 1 3 3 3 - - 0 - - 3 3 3
0 0 0 - 1 1 3 3 3 - 1 1 1 - 3 3 3
0 0 0 - 2 1 3 3 3 - 1 1 1 - 3 3 3
0 0 0 - 1 1 - - - - 2 2 2 - - - -
0 0 0 - 2 0 - 1 1 2 2 2 2 - 3 3 3
0 0 0 0 0 0 0 1 1 2 2 2 2 2 3 3 3
0 0 0 - 2 0 - 1 1 2 2 2 2 - 3 3 3
0 0 0 - 1 1 - - - - 2 2 2 - - - -
0 0 0 - 2 1 3 3 3 - 1 1 1 - 3 3 3
0 0 0 - 1 1 3 3 3 - 1 1 1 - 3 3 3
0 0 0 - 2 1 3 3 3 - - 0 - - 3 3 3
0 0 0 - 1 1 1 1 1 1 0 0 0 1 1 1 1
0 0 0 - 2 1 2 1 2 1 2 0 2 1 2 1 2
0 0 0 - - - - - - - - 0 - - - - -
0 0 0 0 0 0 0 0 0 0 0 0 0 0 0 0 0
0 0 0 0 0 0 0 0 0 0 0 0 0 0 0 0 0
++END++
++PLACEMENTS++
0 0 0 0 0 0 0 0 0 0 0 0 0 0 0 0 0
0 0 0 0 0 0 0 0 0 0 0 0 0 0 0 0 L
0 0 0 - - - - - - - - 0 - - - - -
0 0 0 - 2 1 2 1 2 1 2 F 2 1 2 1 2
0 0 0 - 1 E 1 1 1 1 R 0 R 1 1 1 1
0 0 0 - 2 E U 3 3 - - R - - 3 3 U
0 0 0 - 1 1 3 L 3 - T 1 1 - 3 L 3
0 0 0 - 2 1 3 3 U - R R R - U 3 3
0 0 0 - 1 1 - - - - F F F - - - -
0 0 0 - 2 R - T R F 2 2 2 - 3 3 3
I 0 0 0 F 0 R 1 R F 2 P 2 R 3 O 3
0 0 0 - 2 R - T R F 2 2 2 - 3 3 3
0 0 0 - 1 1 - - - - F F F - - - -
0 0 0 - 2 1 3 3 U - R R R - U 3 3
0 0 0 - 1 1 3 L 3 - T 1 1 - 3 L 3
0 0 0 - 2 1 U 3 3 - - R - - 3 3 U
0 0 0 - 1 1 1 1 1 1 R 0 R 1 1 1 E
0 0 0 - 2 1 2 1 2 1 2 F 2 1 2 1 2
0 0 0 - - - - - - - - 0 - - - - -
0 0 0 0 0 0 0 0 0 0 0 0 0 0 0 0 L
0 0 0 0 0 0 0 0 0 0 0 0 0 0 0 0 0
++END++
++PATROL ROUTES++
5,4-16,4
5,5-5,15
16,16-5,16
++END++
++TERMINAL ASSIGNMENTS++
10,6-9,9-9,10-9,11-8,13-6,15
10,14-9,9-9,10-9,11-8,7-6,5
7,9-10,13-11,13-12,13-14,14-16,16
7,11-10,8-11,8-12,8,-14,7-16,5
++END++
++LOOT VALUES++
16,1-10
16,20-10
7,6-15
15,6-15
7,14-15
15,14-15
15,10-70
++END++
++ENDFILE++

