++LAYOUT++
2 1 2 1 2 1 2 1 2 1 2 1 2 1 2 1 2 1 2 1 2
1 1 1 1 1 1 1 1 1 1 1 1 1 1 1 1 1 1 1 1 1
2 1 1 1 1 1 1 1 1 1 1 1 1 1 1 1 1 1 1 1 2
1 1 1 - - - - - - - - - - - - - - - 1 1 1
2 1 1 - - 2 1 2 1 2 1 2 1 2 1 2 - - 1 1 2
1 1 1 - - 1 3 1 1 1 1 1 1 1 3 1 - - 1 1 1
2 1 1 1 - 2 1 - - - - - - - 1 2 - - 1 1 2
1 1 3 0 - 1 1 - - - - - - - 1 1 - - 1 1 1
0 0 0 0 - 2 1 - - - - - - - 1 2 - - 1 1 2
1 1 3 0 - 1 1 - - - - - - - 1 1 - - 1 1 1
2 1 1 1 - 2 1 - - - - - - - 1 2 - - 1 1 2
1 1 1 - - 1 3 1 1 1 1 1 1 1 3 1 - - 1 1 1
2 1 1 - - 2 1 2 1 2 1 2 1 2 1 2 - - 1 1 2
1 1 1 - - - - - - - - - - - - - - - 1 1 1
2 1 1 1 1 1 1 1 1 1 1 1 1 1 1 1 1 1 1 1 2
1 1 1 1 1 1 1 1 1 1 1 1 1 1 1 1 1 1 1 1 1
2 1 2 1 2 1 2 1 2 1 2 1 2 1 2 1 2 1 2 1 2
++END++
++PLACEMENTS++
2 1 2 1 2 1 2 1 2 1 2 1 2 1 2 1 2 1 2 1 2
1 T 1 1 1 1 1 1 1 1 1 1 1 1 1 1 1 1 1 T 1
2 1 E 1 1 1 1 1 1 1 1 1 1 1 1 1 1 1 E 1 2
1 1 1 - - - - - - - - - - - - - - - 1 1 1
2 1 1 - - L 1 2 1 2 1 2 1 2 1 L - - 1 1 2
1 1 1 - - 1 U 1 1 1 1 1 1 1 U 1 - - 1 1 1
2 1 1 1 - 2 1 - - - - - - - 1 2 - - 1 O 2
1 1 3 R - 1 1 - - - - - - - 1 1 - - 1 1 1
0 0 0 0 - 2 1 - - - - - - - 1 2 - - 1 1 2
1 1 3 R - 1 1 - - - - - - - 1 1 - - 1 1 1
2 1 1 1 - 2 1 - - - - - - - 1 2 - - 1 P 2
1 1 1 - - 1 U 1 1 1 1 1 1 1 U 1 - - 1 1 1
2 1 1 - - L 1 2 1 2 1 2 1 2 1 L - - 1 1 2
1 1 1 - - - - - - - - - - - - - - - 1 1 1
2 1 E 1 1 1 1 1 1 1 1 1 1 1 1 1 1 1 E 1 2
1 T 1 1 1 1 1 1 1 1 1 1 1 1 1 1 1 1 1 T 1
2 1 2 1 2 1 2 1 2 1 2 1 2 1 2 1 2 1 2 1 2
++END++
++PATROL ROUTES++
2,2-3,8-2,14-11,14-18,14-18,8-18,2-11,2
18,2-11,2-2,2-3,8-2,14-11,14-18,14-18,8
18,14-18,8-18,2-11,2-2,2-3,8-2,14-11,14
2,14-11,14-18,14-18,8-18,2-11,2-2,2-3,8
++END++
++LOOT VALUES++
5,4-10
15,4-10
5,12-10
15,12-10
19,6-65
++END++
++TERMINAL ASSIGNMENTS++
1,1-14,11
1,15-14,5
19,15-6,5
19,1-6,11
++END++
++ENDFILE++

