++LAYOUT++
2 1 2 1 2 1 2 1 2 1 2 1 2 1 2 1 2 1 2
1 1 1 1 1 1 1 1 1 1 1 1 1 1 1 1 1 1 1
2 1 - - - - - - - 1 - - - - - - - 1 2
1 1 - - 3 2 3 2 3 1 3 2 3 2 3 - - 1 1
2 1 - - 2 2 2 2 1 1 1 2 2 2 2 - - 1 2
1 1 1 - 3 2 1 1 1 1 1 1 1 2 3 - - 1 1
2 3 0 - 2 2 1 1 1 1 1 1 1 2 2 - - 1 2
0 0 0 - 3 2 1 1 1 1 1 1 1 2 3 - - 1 1
2 3 0 - 2 2 1 1 1 1 1 1 1 2 2 - - 1 2
1 1 1 - 3 2 1 1 1 1 1 1 2 2 3 - - 1 1
2 1 - - 2 2 2 2 1 1 1 2 2 2 2 - - 1 2
1 1 - - 3 2 3 2 3 1 3 2 3 2 3 - - 1 1
2 1 - - - - - - - 1 - - - - - - - 1 2 
1 1 1 1 1 1 1 1 1 1 1 1 1 1 1 1 1 1 1
2 1 2 1 2 1 2 1 2 1 2 1 2 1 2 1 2 1 2
++END++
++PLACEMENTS++
2 1 2 1 2 1 2 1 2 1 2 1 2 1 2 1 2 1 2
1 E 1 1 1 1 1 1 1 1 1 1 1 1 1 1 1 L 1
2 1 - - - - - - - 1 - - - - - - - 1 2
1 1 - - U 2 3 2 3 1 3 2 3 2 U - - 1 1
2 1 - - 2 2 2 2 R 1 R 2 2 2 2 - - 1 2
1 1 1 - 3 2 1 1 1 1 1 1 1 2 3 - - 1 1
2 U R - 2 2 1 1 1 1 1 1 1 2 2 - - 1 2
0 0 0 - 3 E 1 1 1 O 1 1 1 E 3 - - E 1
2 U R - 2 2 1 1 1 1 1 1 1 2 2 - - 1 2
1 1 1 - 3 2 1 1 1 1 1 1 2 2 3 - - 1 1
2 1 - - 2 2 2 2 R 1 R 2 2 P 2 - - 1 2
1 1 - - U 2 3 2 3 1 3 2 3 2 U - - 1 1
2 1 - - - - - - - 1 - - - - - - - 1 2 
1 E 1 1 1 1 1 1 1 1 1 1 1 1 1 1 1 L 1
2 1 2 1 2 1 2 1 2 1 2 1 2 1 2 1 2 1 2
++END++
++PATROL ROUTES++
1,1-9,1-17,1-17,7-17,13-9,13-1,13-2,7
1,13-2,7-1,1-9,1-17,1-17,7-17,13-9,13
17,7-17,13-9,13-1,13-2,7-1,1-9,1-17,1
5,7-9,9-13,7-9,5
13,7-9,5-5,7-9,9
++END++
++LOOT VALUES++
17,1-15
17,13-15
9,7-70
++END++
++ENDFILE++

