++LAYOUT++
0 0 0 0 0 0 0 0 0 0 0 0 0 0 0 0 0
0 - - - - - - - - - - - - - - - 0
0 - 2 1 2 1 2 1 2 1 2 1 2 1 2 - 0
0 - 1 1 1 1 1 1 1 1 1 1 1 1 1 - 0
0 - 2 1 3 3 0 0 0 0 0 3 3 1 2 - 0
0 - 1 1 3 3 0 0 0 0 0 3 3 1 1 - 0
0 - 2 1 0 0 0 0 0 0 0 0 0 1 2 - 0
0 0 0 1 0 0 0 0 0 0 0 0 0 1 1 - 0
0 - 2 1 0 0 0 0 0 0 0 0 0 1 2 - 0
0 - 1 1 3 3 0 0 0 0 0 3 3 1 1 - 0
0 - 2 1 3 3 0 0 1 0 0 3 3 1 2 - 0
0 - 1 1 1 1 1 1 1 1 1 1 1 1 1 - 0
0 - 2 1 2 1 2 1 2 1 2 1 2 1 2 - 0
0 - - - - - - - 2 - - - - - - - 0
0 - - - - - - - 2 - - - - - - - 0
0 - 2 1 2 1 2 1 2 1 2 1 2 1 2 - 0
0 - 1 1 1 1 1 1 1 1 1 1 1 1 1 - 0
0 - 2 1 3 3 0 0 1 0 0 3 3 1 2 - 0
0 - 1 1 3 3 0 0 0 0 0 3 3 1 1 - 0
0 - 2 1 0 0 0 0 0 0 0 0 0 1 2 - 0
0 0 0 1 0 0 0 0 0 0 0 0 0 1 1 - 0
0 - 2 1 0 0 0 0 0 0 0 0 0 1 2 - 0
0 - 1 1 3 3 0 0 0 0 0 3 3 1 1 - 0
0 - 2 1 3 3 0 0 0 0 0 3 3 1 2 - 0
0 - 1 1 1 1 1 1 1 1 1 1 1 1 1 - 0
0 - 2 1 2 1 2 1 2 1 2 1 2 1 2 - 0
0 - - - - - - - - - - - - - - - 0
0 0 0 0 0 0 0 0 0 0 0 0 0 0 0 0 0
++END++
++PLACEMENTS++
0 0 0 0 0 0 0 0 0 0 0 0 0 0 0 0 0
0 - - - - - - - - - - - - - - - 0
0 - 2 1 2 1 2 1 2 1 2 1 2 1 2 - 0
0 - 1 1 1 1 1 1 1 1 1 1 1 E 1 - 0
0 - 2 1 3 3 0 T 0 O 0 3 3 1 2 - 0
0 - 1 1 3 U 0 0 0 0 0 U 3 1 1 - 0
0 - 2 1 0 0 0 0 0 0 0 0 0 1 2 - 0
0 0 R 1 R 0 0 0 0 0 0 0 0 1 1 - 0
0 - 2 1 0 0 0 0 0 0 0 0 0 1 2 - 0
0 - 1 1 3 U 0 0 R 0 0 U 3 1 1 - 0
0 - 2 1 3 3 0 0 1 0 0 3 3 1 2 - 0
0 - 1 E 1 1 1 1 R 1 1 1 1 1 1 - 0
0 - 2 1 2 1 2 1 2 1 2 1 2 1 2 - 0
0 - - - - - - - 2 - - - - - - - 0
0 - - - - - - - 2 - - - - - - - 0
0 - 2 1 2 1 2 1 2 1 2 1 2 1 2 - 0
0 - 1 E 1 1 1 1 R 1 1 1 1 1 1 - 0
0 - 2 1 3 3 0 0 1 0 0 3 3 1 2 - 0
0 - 1 1 3 U 0 0 R 0 0 U 3 1 1 - 0
0 - 2 1 0 0 0 0 0 0 0 0 0 1 2 - 0
0 0 R 1 0 0 0 0 0 0 0 0 0 1 1 - 0
0 - 2 1 0 0 0 0 0 0 0 0 0 1 2 - 0
0 - 1 1 3 U 0 0 0 0 0 U 3 1 1 - 0
0 - 2 1 3 3 0 T 0 P 0 3 3 1 2 - 0
0 - 1 1 1 1 1 1 1 1 1 1 1 E 1 - 0
0 - 2 1 2 1 2 1 2 1 2 1 2 1 2 - 0
0 - - - - - - - - - - - - - - - 0
0 0 0 0 0 0 0 0 0 0 0 0 0 0 0 0 0
++END++
++PATROL ROUTES++
13,3-3,3-3,12-13,12
3,12-13,12-13,3-3,3
3,17-12,17-12,25-3,25
12,25-3,25-3,17-12,17
++END++
++TERMINAL ASSIGNMENTS++
7,4-5,5-11,5-9,5-9,11
7,23-5,22-5,18-12,18-12,22
++END++
++LOOT VALUES++
7,6-90
++END++
++ENDFILE++

