++LAYOUT++
- - - - - - - 0 0 0 0 0 - - - - - - -
- - - - - - - 3 0 0 0 3 - - - - - - -
- - - - - - - 0 0 0 0 0 - - - - - - -
- - - 1 1 1 1 3 0 0 0 3 1 1 1 1 - - -
- - - 1 1 1 1 0 0 0 0 0 1 1 1 1 - - -
- - - 1 1 1 1 3 0 0 0 3 1 1 1 1 - - -
- - - 1 1 1 1 0 0 0 0 0 1 1 1 1 - - -
0 3 0 3 0 3 0 3 0 0 0 3 0 3 0 3 0 3 0
0 0 0 0 0 0 0 0 0 0 0 0 0 0 0 0 0 0 0
0 0 0 0 0 0 0 0 0 0 0 0 0 0 0 0 0 0 0
0 0 0 0 0 0 0 0 0 0 0 0 0 0 0 0 0 0 0
0 3 0 3 0 3 0 3 0 0 0 3 0 3 0 3 0 3 0
- - - 1 1 1 1 0 0 0 0 0 1 1 1 1 - - -
- - - 1 1 1 1 3 0 0 0 3 1 1 1 1 - - -
- - - 1 1 1 1 0 0 0 0 0 1 1 1 1 - - -
- - - 1 1 1 1 3 0 0 0 3 1 1 1 1 - - -
- - - - - - - 0 0 0 0 0 - - - - - - -
- - - - - - - 3 0 0 0 3 - - - - - - -
- - - - - - - 0 0 0 0 0 - - - - - - -
++END++
++PLACEMENTS++
- - - - - - - 0 0 X 0 0 - - - - - - -
- - - - - - - 3 0 0 0 3 - - - - - - -
- - - - - - - L 0 0 0 0 - - - - - - -
- - - 1 1 1 1 3 0 0 0 3 1 1 1 1 - - -
- - - 1 1 1 1 R 0 0 0 R 1 1 1 1 - - -
- - - 1 1 1 1 3 0 0 0 3 1 1 1 1 - - -
- - - 1 1 1 1 R 0 0 0 R 1 1 1 1 - - -
0 3 0 3 U 3 1 3 0 0 0 3 1 3 U 3 0 3 0
0 0 0 0 0 0 0 0 0 0 0 0 0 0 0 0 0 0 0
I 0 0 0 0 0 0 0 0 H 0 0 0 0 0 0 0 0 X
0 0 0 0 0 0 0 0 0 0 0 0 0 0 0 0 0 0 0
0 3 0 3 U 3 1 3 0 0 0 3 1 3 U 3 0 3 0
- - - 1 1 1 1 R 0 0 0 R 1 1 1 1 - - -
- - - 1 1 1 1 3 0 0 0 3 1 1 1 1 - - -
- - - 1 1 1 1 R 0 0 0 R 1 1 1 1 - - -
- - - 1 1 1 1 3 0 0 0 3 1 1 1 1 - - -
- - - - - - - 0 0 0 0 L - - - - - - -
- - - - - - - 3 0 0 0 3 - - - - - - -
- - - - - - - 0 0 X 0 0 - - - - - - -
++END++
++LOOT VALUES++
7,2-20
11,16-20
++END++
++ENDFILE++

