++LAYOUT++
- - - - - 0 0 0 0 0 - - - - -
- - - - - 0 0 0 0 0 - - - - -
- - - - - 0 0 0 0 0 - - - - -
- - - - - 0 0 0 0 0 - - - - -
3 1 3 1 3 1 3 1 3 1 3 1 3 1 3
1 1 1 1 1 1 1 1 1 1 1 1 1 1 1
1 1 1 1 1 1 1 1 1 1 1 1 1 1 1
1 1 1 1 1 1 1 1 1 1 1 1 1 1 1
3 1 3 1 3 1 3 1 3 1 3 1 3 1 3
++END++
++PLACEMENTS++
- - - - - 0 0 X 0 0 - - - - -
- - - - - 0 0 0 0 0 - - - - -
- - - - - 0 0 0 0 0 - - - - -
- - - - - R 0 R 0 R - - - - -
3 1 3 1 3 F 3 F 3 F 3 1 3 1 3
1 1 1 1 1 1 1 1 1 1 1 1 E 1 1
I 1 1 1 1 1 1 1 1 T 1 1 1 1 X
1 1 E 1 1 1 1 1 1 1 1 1 1 1 1
3 1 3 1 3 1 3 1 3 1 3 1 3 1 3
++END++
++PATROL ROUTES++
12,5-2,5-2,7-12,7
2,7-12,7-12,5-2,5
++END++
++ENDFILE++

