++LAYOUT++
- - - - - - - 0 0 0 0 0 0 - - - - - - -
- - - - - - - 3 0 0 0 0 3 - - - - - - -
- - - - - - - 0 0 0 0 0 0 - - - - - - -
- - - 1 1 1 1 3 1 1 1 1 3 1 1 1 1 - - -
- - - 1 1 1 1 1 1 1 1 1 1 1 1 1 1 - - -
- - - 1 1 1 1 3 2 2 2 2 3 1 1 1 1 - - -
- - - 1 1 1 1 1 2 2 2 2 1 1 1 1 1 - - -
0 3 0 3 1 3 1 3 3 3 3 3 3 1 3 1 3 0 3 0
0 0 0 1 1 2 2 3 3 3 3 3 3 2 2 1 1 0 0 0
0 0 0 1 1 2 2 3 3 3 3 3 3 2 2 1 1 0 0 0
0 0 0 1 1 2 2 3 3 3 3 3 3 2 2 1 1 0 0 0
0 3 0 3 1 3 1 3 3 3 3 3 3 1 3 1 3 0 3 0
- - - 1 1 1 1 1 2 2 2 2 1 1 1 1 1 - - -
- - - 1 1 1 1 3 2 2 2 2 3 1 1 1 1 - - -
- - - 1 1 1 1 1 1 1 1 1 1 1 1 1 1 - - -
- - - 1 1 1 1 3 1 1 1 1 3 1 1 1 1 - - -
- - - - - - - 0 0 0 0 0 0 - - - - - - -
- - - - - - - 3 0 0 0 0 3 - - - - - - -
- - - - - - - 0 0 0 0 0 0 - - - - - - -
++END++
++PLACEMENTS++
- - - - - - - 0 0 0 X 0 0 - - - - - - -
- - - - - - - 3 0 0 0 0 3 - - - - - - -
- - - - - - - 0 0 R R 0 0 - - - - - - -
- - - U 1 1 1 3 1 1 1 1 3 1 1 1 U - - -
- - - 1 E 1 1 1 1 R R 1 1 1 1 E 1 - - -
- - - 1 1 1 1 3 2 2 2 2 3 1 1 1 1 - - -
- - - 1 1 1 1 1 2 R R 2 1 1 1 1 1 - - -
0 3 0 3 1 3 1 3 3 3 3 3 3 1 3 1 3 0 3 0
0 0 0 1 1 2 2 3 3 3 3 3 3 2 2 1 1 0 0 0
0 0 R 1 R 2 R 3 3 L H 3 3 R 2 R 1 R 0 X
I 0 R 1 R 2 R 3 3 H T 3 3 R 2 R 1 R 0 0
0 0 0 1 1 2 2 3 3 3 3 3 3 2 2 1 1 0 0 0
0 3 0 3 1 3 1 3 3 3 3 3 3 1 3 1 3 0 3 0
- - - 1 1 1 1 1 2 R R 2 1 1 1 1 1 - - -
- - - 1 1 1 1 3 2 2 2 2 3 1 1 1 1 - - -
- - - 1 E 1 1 1 1 R R 1 1 1 1 E 1 - - -
- - - U 1 1 1 3 1 1 1 1 3 1 1 1 U - - -
- - - - - - - 0 0 R R 0 0 - - - - - - -
- - - - - - - 3 0 0 0 0 3 - - - - - - -
- - - - - - - 0 0 X 0 0 0 - - - - - - -
++END++
++PATROL ROUTES++
4,4-15,4-15,15-4,15
15,4-15,15-4,15-4,4
15,15-4,15-4,4-15,4
4,15-4,4-15,4-15,15
++END++
++LOOT VALUES++
9,9-25
++END++
++ENDFILE++

