++LAYOUT++
1 1 0 0 0 0 0 0 0 0 0 0
1 1 0 0 0 0 0 0 0 0 0 0
1 1 0 0 0 0 2 2 0 0 0 0
1 1 0 0 0 0 2 2 0 0 0 0
1 1 0 0 0 0 1 1 0 0 0 0
1 1 0 0 0 0 1 1 0 0 0 0
1 1 1 1 1 1 1 1 1 1 1 1
1 1 1 1 1 1 1 1 1 1 1 1
++END++
++PLACEMENTS++
H L R 0 0 0 0 0 0 X 0 0
1 1 R 0 0 0 0 0 0 E 0 0
1 1 0 0 0 0 U 2 0 0 0 0
1 1 0 0 0 0 2 2 0 0 0 0
I 1 0 0 0 0 R R 0 0 0 0
1 1 0 0 0 0 1 1 0 0 R R
1 1 1 1 1 1 1 1 1 E 1 1
1 1 1 1 1 1 1 1 E 1 1 1
++END++
++PATROL ROUTES++
9,1-4,1-4,4
8,7-3,7
9,6-4,7
++END++
++LOOT VALUES++
1,0-25
++END++
++ENDFILE++

