++LAYOUT++
0 0 0 0 0 0 0 0 0 0 - -
0 0 0 0 0 0 0 0 0 0 - -
0 0 0 0 0 0 0 0 0 0 - -
0 0 - - - - - 0 0 0 - -
0 0 - 2 2 2 - 0 0 0 - -
0 0 - 2 2 2 - 0 0 0 0 0
0 0 - 2 2 2 - 0 0 0 0 0
0 0 - 2 2 2 - 0 0 0 - -
0 0 - - - - - 0 0 0 - -
0 0 0 0 0 0 0 0 0 0 - -
0 0 0 0 0 0 0 0 0 0 - -
0 0 0 0 0 0 0 0 0 0 - -
++END++
++PLACEMENTS++
H 0 0 0 0 E 0 0 0 0 - -
0 0 0 0 E 0 0 0 0 0 - -
0 0 0 E 0 0 0 0 0 0 - -
0 0 - - - - - 0 0 0 - -
0 0 - 2 2 2 - 0 0 0 - -
0 0 - 2 L 2 - 0 0 0 0 X
I 0 - 2 L 2 - 0 0 0 0 0
0 0 - 2 2 2 - 0 0 0 - -
0 0 - - - - - 0 0 0 - -
0 0 0 0 0 0 0 0 0 0 - -
0 0 0 0 0 0 0 0 0 0 - -
0 0 0 0 0 0 0 0 0 0 - -
++END++
++PATROL ROUTES++
5,0-9,0-9,9-5,9-9,9-9,0
4,1-8,1-8,10-4,10-8,10,8,1
3,2-7,2-7,11-3,11-7,11,7,2
++END++
++LOOT VALUES++
4,5-20
4,6-20
++END++
++ENDFILE++

