++LAYOUT++
- - - - - - - - - - - - - - - - - - - - - -
- 1 1 1 1 1 1 1 1 1 1 1 1 1 1 1 1 1 1 1 1 -
- 1 3 1 3 1 3 1 3 1 3 1 3 1 3 1 3 1 3 1 3 -
- 1 1 1 1 1 1 1 1 1 1 1 1 1 1 1 1 1 1 1 1 -
- 0 0 0 0 0 0 0 0 0 0 0 1 1 1 1 3 3 3 3 3 -
- 0 0 0 0 0 0 0 0 0 0 0 1 1 1 1 3 0 0 0 3 -
- 0 0 0 0 0 0 0 0 0 0 0 1 1 1 1 1 0 0 0 3 - 
- 0 0 0 0 0 0 0 0 0 0 0 1 1 1 1 1 0 0 0 3 -
- 0 0 0 0 0 0 0 0 0 0 0 1 1 1 1 3 0 0 0 3 -
- 0 0 0 0 0 0 0 0 0 0 0 1 1 1 1 3 3 3 3 3 -
- 1 1 1 1 1 1 1 1 1 1 1 1 1 1 1 1 1 1 1 1 -
- 1 3 1 3 1 3 1 3 1 3 1 3 1 3 1 3 1 3 1 3 -
- 1 1 1 1 1 1 1 1 1 1 1 1 1 1 1 1 1 1 1 1 -
- - - - - - - - - - - - - - - - - - - - - -
++END++
++PLACEMENTS++
- - - - - - - - - - - - - - - - - - - - - -
- 1 1 1 1 1 1 E 1 1 1 1 1 1 1 1 1 1 1 1 1 -
- 1 3 1 3 1 3 1 3 1 3 1 3 1 3 1 3 1 3 1 3 -
- 1 1 1 1 E 1 1 1 1 1 1 1 1 1 1 1 1 1 1 1 -
- 0 0 0 R R R R R R 0 0 1 1 1 1 3 3 3 3 3 -
- 0 0 0 0 0 0 0 0 0 0 0 U 1 1 1 3 0 0 O 3 -
- 0 0 0 0 0 0 0 0 0 0 0 1 1 1 1 F R 0 L 3 - 
- 0 0 0 0 0 0 0 0 0 0 0 1 1 1 1 F R 0 L 3 -
- 0 0 0 0 0 0 0 0 0 0 0 U 1 1 1 3 0 0 L 3 -
- 0 0 0 R R R R R R 0 0 1 1 1 1 3 3 3 3 3 -
- 1 1 P 1 1 1 1 1 1 1 1 1 1 1 E 1 1 1 1 1 -
- 1 3 1 3 1 3 1 3 1 3 1 3 1 3 1 3 1 3 1 3 -
- 1 1 1 1 1 1 1 1 1 1 1 1 E 1 1 1 1 1 1 1 -
- - - - - - - - - - - - - - - - - - - - - -
++END++
++PATROL ROUTES++
7,1-15,1-15,10-7,10
5,3-13,3-13,12-5,12
15,10-7,10-7,1-15,1
13,12-5,12-5,3-13,3
++END++
++LOOT VALUES++
19,5-60
19,6-15
19,7-15
19,8-15
++END++
++ENDFILE++

