++LAYOUT++
0 0 0 0 0 0 0 0 0 0 0 0 0 0 0 0 0 0 0 0 0
0 0 0 0 0 0 0 0 0 0 0 0 0 0 0 0 0 0 0 0 0
0 0 2 2 2 2 2 2 2 2 2 2 2 2 2 2 2 2 2 0 0
0 0 2 3 3 3 3 3 3 3 3 3 3 3 3 3 3 3 2 0 0
0 0 2 3 3 3 3 3 3 3 3 3 3 3 3 3 3 3 2 0 0
0 0 2 3 3 3 3 3 3 3 3 3 3 3 3 3 3 3 2 0 0
0 0 2 3 3 0 0 0 0 0 0 0 0 0 0 3 3 3 2 0 0
0 0 2 3 3 0 3 0 3 0 3 0 3 0 3 3 3 3 2 0 0
0 0 0 0 0 0 0 0 0 0 0 1 1 2 2 3 3 3 2 0 0
0 0 0 0 0 0 0 0 0 0 0 1 1 2 2 3 3 3 2 0 0
0 0 0 0 0 0 0 0 0 0 0 1 1 2 2 3 3 3 2 0 0
0 0 2 3 3 0 3 0 3 0 3 0 3 0 3 3 3 3 2 0 0
0 0 2 3 3 0 0 0 0 0 0 0 0 0 0 3 3 3 2 0 0
0 0 2 3 3 3 3 3 3 3 3 3 3 3 3 3 3 3 2 0 0
0 0 2 3 3 3 3 3 3 3 3 3 3 3 3 3 3 3 2 0 0
0 0 2 3 3 3 3 3 3 3 3 3 3 3 3 3 3 3 2 0 0
0 0 2 2 2 2 2 2 2 2 2 2 2 2 2 2 2 2 2 0 0
0 0 0 0 0 0 0 0 0 0 0 0 0 0 0 0 0 0 0 0 0
0 0 0 0 0 0 0 0 0 0 0 0 0 0 0 0 0 0 0 0 0
++END++
++PLACEMENTS++
0 0 0 0 0 0 0 0 0 0 0 0 0 0 0 0 0 0 0 0 0
0 0 0 0 0 0 0 0 0 0 0 0 0 0 0 0 0 0 0 0 0
0 0 2 2 2 2 2 2 2 2 2 2 2 2 2 2 2 2 2 0 0
0 0 2 3 3 3 E 3 3 3 3 3 3 3 3 3 3 3 2 0 0
0 0 2 3 3 P 3 3 3 3 3 3 3 3 3 3 3 3 2 0 0
0 0 2 3 3 3 3 3 3 3 3 3 3 3 3 E 3 3 2 0 0
0 0 U 3 3 0 0 0 0 0 0 0 0 0 L 3 3 3 2 0 0
0 0 2 3 3 0 3 0 3 0 3 0 3 0 3 3 3 3 2 0 0
0 0 0 0 0 0 0 0 0 0 0 1 1 2 2 3 3 3 2 0 0
I 0 0 0 0 0 0 0 0 0 0 1 1 2 2 3 3 3 2 0 0
0 0 0 0 0 0 0 0 0 0 0 1 1 2 2 3 3 3 2 0 0
0 0 2 3 3 0 3 0 3 0 3 0 3 0 3 3 3 3 2 0 0
0 0 U 3 3 0 0 0 0 0 0 0 0 0 L 3 3 3 2 0 0
0 0 2 3 3 3 E 3 3 3 3 3 3 3 3 3 3 3 2 0 0
0 0 2 3 3 O 3 3 3 3 3 3 3 3 3 3 3 3 2 0 0
0 0 2 3 3 3 3 3 3 3 3 3 3 3 3 3 3 E 2 0 0
0 0 2 2 2 2 2 2 2 2 2 2 2 2 2 2 2 2 2 0 0
0 0 0 0 0 0 0 0 0 0 0 0 0 0 0 0 0 0 0 0 0
0 0 0 0 0 0 0 0 0 0 0 0 0 0 0 0 0 0 0 0 0
++END++
++PATROL ROUTES++
15,5-6,5-6,3-17,3-17,15-6,15-6,13-15,13
6,3-17,3-17,15-6,15-6,13-15,13-15,5-6,5
17,15-6,15-6,13-15,13-15,5-6,5-6,3-17,3
6,13-15,13-15,5-6,5-6,3-17,3-17,15-6,15
++END++
++LOOT VALUES++
5,14-75
14,6-15
14,12-15
++END++
++ENDFILE++

