++LAYOUT++
- - - - - - - - - - - - - - - - - -
2 2 2 2 2 2 2 2 2 2 2 2 2 2 2 2 2 -
2 2 2 2 2 2 2 2 2 2 2 2 2 2 2 2 2 -
2 2 2 2 2 2 2 2 2 2 2 2 2 2 2 2 2 -
0 0 0 0 0 0 0 0 0 0 0 1 1 1 1 1 1 -
0 3 0 3 0 3 0 3 0 3 0 1 1 1 1 1 1 -
0 0 0 0 0 0 0 0 0 0 0 1 1 1 1 1 1 -
0 0 0 0 0 0 0 0 0 0 0 1 1 1 1 1 1 -
0 0 0 0 0 0 0 0 0 0 0 1 1 1 1 1 1 -
0 0 0 0 0 0 0 0 0 0 0 1 1 1 1 1 1 -
0 3 0 3 0 3 0 3 0 3 0 1 1 1 1 1 1 -
0 0 0 0 0 0 0 0 0 0 0 1 1 1 1 1 1 -
2 2 2 2 2 2 2 2 2 2 2 2 2 2 2 2 2 -
2 2 2 2 2 2 2 2 2 2 2 2 2 2 2 2 2 -
2 2 2 2 2 2 2 2 2 2 2 2 2 2 2 2 2 -
- - - - - - - - - - - - - - - - - -
++END++
++PLACEMENTS++
- - - - - - - - - - - - - - - - - -
2 2 2 2 2 2 2 2 2 2 2 2 2 2 2 2 2 -
2 2 L 2 L 2 L 2 2 2 2 2 O 2 2 2 2 -
2 2 E 2 2 2 2 2 2 2 2 2 2 2 2 2 2 -
0 0 0 0 0 0 0 0 0 0 0 R R R R R R -
0 3 0 3 0 3 0 3 0 3 0 1 1 1 1 1 H -
0 0 E 0 0 0 0 0 0 0 R 1 1 1 1 1 1 -
0 0 0 0 0 0 0 0 0 0 R 1 1 1 1 1 1 -
I 0 0 0 0 0 0 0 0 0 R 1 1 1 1 1 1 -
0 0 0 0 0 0 0 0 0 0 R 1 1 E 1 1 1 -
0 3 0 3 0 3 0 3 0 3 0 1 1 1 1 1 H -
0 0 0 0 0 0 0 0 0 0 0 R R R R R R -
2 2 2 2 2 2 2 2 2 2 2 2 2 2 2 2 2 -
2 2 L 2 L 2 L 2 2 2 2 2 P 2 2 2 2 -
2 2 E 2 2 2 2 2 2 2 2 2 2 2 2 2 2 -
- - - - - - - - - - - - - - - - - -
++END++
++PATROL ROUTES++
2,3-12,3-12,12-2,12-2,14-13,14-13,1-2,1
2,14-14,14-14,1-2,1-2,3-12,3-12,12-2,12
2,6-13,6-13,9-2,9
13,9-2,9-2,6-13,6
++END++
++LOOT VALUES++
2,2-10
4,2-10
6,2-10
12,2-65
2,13-10
4,13-10
6,13-10
++END++
++ENDFILE++

