++LAYOUT++
- - - - - - - - - - - - - - - - - - - -
0 0 0 0 - 1 1 1 1 - 2 2 2 2 - 3 3 3 3 -
0 0 0 0 - 1 1 1 1 1 2 2 2 2 - 3 3 3 3 -
0 0 0 0 - 1 1 1 1 - 2 2 2 2 2 3 3 3 3 -
0 0 0 0 0 1 1 1 1 - 2 2 2 2 - 3 3 3 3 -
0 0 - - - - - 1 1 - - - 2 2 - 3 3 - - - 
0 0 0 0 - 1 1 1 1 - 2 2 2 2 - 3 3 3 3 -
0 0 0 0 - 1 1 1 1 - 2 2 2 2 - 3 3 3 3 -
0 0 0 0 - 1 1 1 1 - 2 2 2 2 - 3 3 3 3 -
0 0 0 0 - 1 1 1 1 - 2 2 2 2 - 3 3 3 3 -
- - 0 0 - 1 1 - - - 2 2 - - - - 3 3 - - 
0 0 0 0 - 1 1 1 1 - 2 2 2 2 - 3 3 3 3 -
0 0 0 0 0 1 1 1 1 - 2 2 2 2 - 3 3 3 3 -
I 0 0 0 - 1 1 1 1 1 2 2 2 2 - 3 3 3 3 -
0 0 0 0 - 1 1 1 1 - 2 2 2 2 - 3 3 3 3 -
- 0 0 - - - - 1 1 - - 2 2 - - - - 3 3 - 
0 0 0 0 - 1 1 1 1 - 2 2 2 2 - 3 3 3 3 -
0 0 0 0 - 1 1 1 1 - 2 2 2 2 - 3 3 3 3 -
0 0 0 0 0 1 1 1 1 - 2 2 2 2 - 3 3 3 3 -
0 0 0 0 - 1 1 1 1 - 2 2 2 2 - 3 3 3 3 -
- - - - - - - - - - - - - - - - - - - - 
++END++
++PLACEMENTS++
- - - - - - - - - - - - - - - - - - - -
0 0 0 0 - R 1 1 1 - 2 2 2 2 - U 3 3 P -
0 0 0 0 - 1 1 1 1 - 2 2 2 2 - 3 3 3 3 -
0 0 0 0 - 1 1 1 1 - 2 2 E 2 R 3 E 3 3 -
0 0 0 0 R 1 1 1 1 - 2 2 2 2 - 3 3 3 3 -
0 0 - - - - - 1 1 - - - 2 2 - 3 3 - - - 
0 0 0 0 - L 1 1 1 - 2 2 2 2 - 3 3 3 L -
0 0 0 0 - 1 1 1 1 R 2 2 2 2 - 3 3 3 3 -
0 0 0 0 - 1 1 1 1 - 2 2 2 2 - 3 3 3 3 -
0 0 0 0 - 1 1 1 1 - 2 2 2 L - 3 3 3 3 -
- - 0 0 - 1 1 - - - 2 2 - - - - 3 3 - - 
0 0 0 0 - 1 1 1 1 - 2 2 2 2 - U 3 3 L -
0 0 0 0 R 1 1 1 1 - 2 2 2 2 - 3 3 3 3 -
I 0 0 0 - 1 1 1 1 R 2 2 2 2 - 3 3 3 3 -
0 0 0 0 - 1 1 1 1 - 2 2 2 2 - 3 3 3 3 -
- 0 0 - - - - 1 1 - - 2 2 - - - - 3 3 - 
0 0 0 0 - 1 1 1 1 - L 2 E 2 - O E 3 3 -
0 0 0 0 - 1 1 1 1 - 2 2 2 2 - 3 3 3 3 -
0 0 0 0 R 1 1 E 1 - 2 2 2 2 - 3 3 3 3 -
0 0 0 0 - 1 1 1 1 - 2 2 2 2 - 3 3 3 3 -
- - - - - - - - - - - - - - - - - - - - 
++END++
++PATROL ROUTES++
16,3-17,8-18,13-18,17-18,13-17,8
16,16-16,13-15,8-15,3-15,8-16,13
12,3-10,8-11,13-11,16-11,13-10,8
12,16-11,11-13,6-13,3-13,6-11,11
7,18-7,13-7,8-7,4-7,8-7,13-7,18
++END++
++LOOT VALUES++
18,6-15
18,11-15
15,16-65
13,9-10
10,16-10
5,6-5
++END++
++ENDFILE++

