++LAYOUT++
- - - - - - - - - - - - - - - - - - - - - -
- 1 1 1 1 1 1 1 1 1 1 1 1 1 1 1 1 1 1 1 1 -
- 1 1 1 1 1 1 1 1 1 1 1 1 1 1 1 1 1 1 1 1 -
- 1 1 1 1 1 1 1 1 1 1 1 1 1 1 1 1 1 1 1 1 -
0 0 0 0 0 0 0 0 0 0 0 0 1 1 1 1 3 3 3 3 3 -
3 0 3 0 3 0 3 0 3 0 3 0 1 1 1 1 3 0 0 0 3 -
0 0 0 0 0 0 0 0 0 0 0 0 1 1 1 1 3 0 0 0 3 -
0 0 0 0 0 0 0 0 0 0 0 0 1 1 1 1 1 0 0 0 3 - 
0 0 0 0 0 0 0 0 0 0 0 0 1 1 1 1 1 0 0 0 3 -
0 0 0 0 0 0 0 0 0 0 0 0 1 1 1 1 3 0 0 0 3 -
3 0 3 0 3 0 3 0 3 0 3 0 1 1 1 1 3 0 0 0 3 -
0 0 0 0 0 0 0 0 0 0 0 0 1 1 1 1 3 3 3 3 3 -
- 1 1 1 1 1 1 1 1 1 1 1 1 1 1 1 1 1 1 1 1 -
- 1 1 1 1 1 1 1 1 1 1 1 1 1 1 1 1 1 1 1 1 -
- 1 1 1 1 1 1 1 1 1 1 1 1 1 1 1 1 1 1 1 1 -
- - - - - - - - - - - - - - - - - - - - - -
++END++
++PLACEMENTS++
- - - - - - - - - - - - - - - - - - - - - -
- 1 1 1 1 1 E 1 1 1 1 1 1 1 1 1 1 1 1 1 1 -
- 1 1 T 1 1 1 1 1 1 1 1 1 1 1 1 1 1 1 1 1 -
- 1 1 1 1 1 1 1 1 1 1 1 E 1 1 1 1 1 1 1 1 -
0 0 0 0 0 0 0 0 0 0 0 0 1 1 1 1 3 3 3 3 3 -
3 0 3 0 3 0 3 0 3 0 3 0 1 1 1 1 3 U 0 U 3 -
0 0 0 0 0 0 0 0 0 0 0 R 1 1 1 1 3 0 0 L 3 -
0 0 0 0 0 0 0 0 0 0 0 R 1 1 1 F F R 0 L 3 - 
I 0 0 0 0 0 0 0 0 0 0 R 1 1 1 F F R 0 O 3 -
0 0 0 0 0 0 0 0 0 0 0 R 1 1 1 1 3 0 0 L 3 -
3 0 3 0 3 0 3 0 3 0 3 0 1 1 1 1 3 U 0 U 3 -
0 0 0 0 0 0 0 0 0 0 0 0 1 1 1 1 3 3 3 3 3 -
- 1 1 1 1 1 E 1 1 1 1 1 1 1 1 1 1 1 1 1 1 -
- 1 1 T 1 1 1 1 1 1 1 1 1 1 1 1 1 1 1 1 1 -
- 1 1 1 1 1 1 1 1 1 1 1 1 1 E 1 1 1 1 1 1 -
- - - - - - - - - - - - - - - - - - - - - -
++END++
++PATROL ROUTES++
6,1-14,1-14,14-6,14-6,12-12,12-12,3-6,3
14,14-6,14-6,12-12,12-12,3-6,3-6,1-14,1
6,12-12,12-12,3-6,3-6,1-14,1-14,14-6,14
12,3-6,3-6,1-14,1-14,14-6,14-6,12-12,12
++END++
++TERMINAL ASSIGNMENTS++
3,2-15,7-16,7-15,8-16,8
3,13-17,5-19,5-17,10-19,10
++END++
++LOOT VALUES++
19,6-15
19,7-15
19,8-65
19,9-15
++END++
++ENDFILE++

