++LAYOUT++
- - - - - - - - - - - - - - - - - - -
- 2 2 2 2 2 2 2 2 2 2 2 2 2 2 2 2 2 -
- 2 2 2 2 2 2 2 2 2 2 2 2 2 2 2 2 2 -
- 2 2 2 2 2 2 2 2 2 2 2 2 2 2 2 2 2 -
- 0 0 0 0 0 0 0 0 0 0 0 1 1 1 1 1 1 -
- 0 3 0 3 0 3 0 3 0 3 0 1 1 1 1 1 1 -
- 0 0 0 0 0 0 0 0 0 0 0 1 1 1 1 1 1 -
- 0 0 0 0 0 0 0 0 0 0 0 1 1 1 1 1 1 -
- 0 0 0 0 0 0 0 0 0 0 0 1 1 1 1 1 1 -
- 0 0 0 0 0 0 0 0 0 0 0 1 1 1 1 1 1 -
- 0 3 0 3 0 3 0 3 0 3 0 1 1 1 1 1 1 -
- 0 0 0 0 0 0 0 0 0 0 0 1 1 1 1 1 1 -
- 2 2 2 2 2 2 2 2 2 2 2 2 2 2 2 2 2 -
- 2 2 2 2 2 2 2 2 2 2 2 2 2 2 2 2 2 -
- 2 2 2 2 2 2 2 2 2 2 2 2 2 2 2 2 2 -
- - - - - - - - - - - - - - - - - - -
++END++
++PLACEMENTS++
- - - - - - - - - - - - - - - - - - -
- 2 2 2 2 2 2 2 2 2 2 2 2 2 2 2 2 2 -
- 2 2 L 2 L 2 L 2 2 2 2 2 O 2 2 2 2 -
- 2 2 E 2 2 2 2 2 2 2 2 2 2 2 2 2 2 -
- 0 0 0 0 0 0 0 0 0 0 0 R R R R R R -
- 0 3 0 3 0 3 0 3 0 3 0 1 1 1 1 1 H -
- 0 0 E 0 0 0 0 0 0 0 R 1 1 1 1 1 1 -
- 0 0 0 0 0 0 0 0 0 0 R 1 1 1 1 1 1 -
- 0 0 0 0 0 0 0 0 0 0 R 1 1 1 1 1 1 -
- 0 0 0 0 0 0 0 0 0 0 R 1 1 E 1 1 1 -
- 0 3 0 3 0 3 0 3 0 3 0 1 1 1 1 1 H -
- 0 0 0 0 0 0 0 0 0 0 0 R R R R R R -
- 2 2 2 2 2 2 2 2 2 2 2 2 2 2 2 2 2 -
- 2 2 L 2 L 2 L 2 2 2 2 2 P 2 2 2 2 -
- 2 2 E 2 2 2 2 2 2 2 2 2 2 2 2 2 2 -
- - - - - - - - - - - - - - - - - - -
++END++
++PATROL ROUTES++
3,3-13,3-13,12-3,12-3,14-15,14-15,1-3,1
3,14-15,14-15,1-3,1-3,3-13,3-13,12-3,12
3,6-14,6-14,9-3,9
14,9-3,9-3,6-14,6
++END++
++LOOT VALUES++
3,2-10
5,2-10
7,2-10
13,2-65
3,13-10
5,13-10
7,13-10
++END++
++ENDFILE++

