++LAYOUT++
0 0 0 - - - - 3 3 3 3 3 
0 0 0 - - 3 3 3 3 3 3 3
0 0 0 - - 3 3 3 3 3 3 3
0 0 0 - - - - - - - 3 3
0 0 0 1 1 2 2 2 2 3 3 3
0 0 0 1 1 2 2 2 2 3 3 3
0 0 0 - - - - - - - 3 3
0 0 0 - - 3 3 3 3 3 3 3
0 0 0 - - 3 3 3 3 3 3 3
0 0 0 - - - - 3 3 3 3 3
++END++
++PLACEMENTS++
0 E 0 - - - - 3 3 O 3 3 
E 0 P - - 3 3 3 3 3 3 3
0 0 0 - - 3 U 3 3 3 3 3
0 0 0 - - - - - - - 3 3
0 0 R 1 R 2 2 2 R E 3 3
0 0 R 1 R 2 2 2 R 3 E 3
0 0 0 - - - - - - - 3 3
I 0 0 - - 3 U 3 3 3 3 3
0 0 0 - - 3 3 3 3 3 3 3
0 0 0 - - - - 3 3 L 3 3
++END++
++PATROL ROUTES++
1,0-1,8
0,1-0,9
9,4-4,4
10,5-5,5
++END++
++LOOT VALUES++
9,0-75
9,9-50
++END++
++ENDFILE++

