++LAYOUT++
0 2 1 1 1 1 1 1 1 1 1 1 2
0 1 0 0 0 0 0 0 0 0 0 0 1
0 1 0 0 0 0 0 0 0 0 0 0 1
0 1 0 0 3 2 2 2 2 3 0 0 1
0 2 0 0 2 1 1 1 1 2 0 0 1
0 0 0 0 0 0 1 1 1 2 0 0 1
0 2 0 0 2 1 1 1 1 2 0 0 1
0 1 0 0 3 2 2 2 2 3 0 0 1
0 1 0 0 0 0 0 0 0 0 0 0 1
0 1 0 0 0 0 0 0 0 0 0 0 1
0 2 1 1 1 1 1 1 1 1 1 1 2
++END++
++PLACEMENTS++
0 U R 1 1 1 1 1 1 1 1 R U
0 R 0 0 0 0 0 0 0 0 E O R
0 1 E 0 0 0 0 0 0 0 0 0 1
0 1 0 0 U R 2 2 R U 0 0 1
0 2 0 0 L 0 1 1 T R 0 0 1
I F 0 0 F R 1 1 R 2 0 0 1
0 2 0 0 L 0 1 1 M R 0 0 1
0 1 0 0 U R 2 2 R U 0 0 1
0 1 0 0 0 0 0 0 0 0 0 E 1
0 R 0 E 0 0 0 0 0 0 0 P R
0 U R 1 1 1 1 1 1 1 1 R U
++END++
++PATROL ROUTES++
2,2-10,2-10,9-2,9
10,1-10,9-3,9-3,1
11,9-2,9-2,2-11,2
3,10-3,1-10,1-10,10
++END++
++LOOT VALUES++
8,6-90
4,4-15
4,6-15
++END++
++TERMINAL ASSIGNMENTS++
8,4-4,3-4,8-9,3-9,8
++END++
++ENDFILE++

