++LAYOUT++
- - - - - - - - - - - - - - - - - - -
- 0 0 2 2 2 2 2 2 2 3 3 0 0 0 0 0 0 -
- 0 0 2 0 0 0 0 1 0 0 3 0 0 2 2 2 0 -
- 1 0 2 0 0 0 0 1 0 0 3 0 1 0 0 2 0 -
- 1 0 2 0 0 0 1 1 0 0 3 0 1 0 0 1 1 -
- 1 0 1 0 0 2 1 0 0 0 3 0 1 1 1 1 1 -
- 1 0 1 0 0 2 1 0 0 0 3 0 0 0 0 0 1 -
- 1 0 1 0 1 2 1 1 1 0 3 1 1 1 0 0 2 -
0 1 0 1 0 1 2 0 0 0 0 0 1 0 0 0 0 2 -
0 0 0 1 0 1 2 2 2 0 0 0 1 3 3 3 2 2 -
0 0 0 1 1 1 1 1 1 1 1 1 1 3 0 0 0 2 -
- 0 0 1 0 2 2 2 2 2 2 2 1 3 0 0 0 2 -
- 0 1 1 0 0 0 1 1 1 1 2 1 3 0 1 0 2 -
- 0 1 3 3 2 2 2 2 2 2 2 1 3 0 1 0 2 -
- 0 1 3 0 0 0 1 0 0 0 0 1 3 0 1 0 2 -
- 0 1 3 0 0 1 1 0 0 0 0 1 3 0 1 0 2 -
- 0 1 3 3 3 3 3 3 3 3 0 1 3 0 1 0 2 -
- 0 0 0 1 1 1 2 2 2 3 0 1 1 1 1 2 2 -
- - - - - - - - - - - - - - - - - - -
++END++
++PLACEMENTS++
- - - - - - - - - - - - - - - - - - -
- 0 0 2 2 2 2 2 2 R 3 E 0 0 0 0 0 0 -
- R 0 2 0 0 0 0 1 0 0 3 0 R 2 2 2 0 -
- 1 0 2 0 T 0 0 1 0 0 U 0 1 R 0 2 P -
- 1 0 2 0 0 0 1 1 R 0 3 0 1 L 0 R O -
- 1 0 R 0 0 2 1 0 0 0 U 0 1 1 1 1 1 -
- 1 0 1 0 R 2 1 0 0 0 3 0 0 0 0 0 R -
- 1 0 1 0 1 2 1 1 1 0 U 1 1 E 0 0 2 -
0 L 0 1 0 1 2 0 0 0 0 0 1 0 0 0 0 2 -
I 0 0 1 0 1 2 2 2 0 0 0 1 3 3 3 R 2 -
0 0 R 1 1 1 1 1 1 1 1 1 1 3 0 0 0 2 -
- 0 0 1 0 L 2 E 2 2 2 2 1 3 0 R 0 2 -
- 0 1 1 R 0 R 1 1 1 T 2 1 U 0 1 0 2 -
- 0 1 3 3 R 2 2 2 2 2 2 1 3 0 1 0 2 -
- 0 1 3 0 0 0 R 0 0 0 0 1 U 0 1 0 2 -
- 0 1 3 0 R 1 1 R 0 0 0 1 3 0 1 0 2 -
- 0 1 3 3 3 3 3 3 3 3 0 1 U 0 1 L 2 -
- 0 0 R 1 1 R 2 2 R 3 0 1 1 1 R 2 2 -
- - - - - - - - - - - - - - - - - - -
++END++
++PATROL ROUTES++
11,1-3,1-3,6-3,1
14,7-12,10-12,17-17,17-12,17-12,10
7,11-11,9-3,9
++END++
++LOOT VALUES++
14,4-15
1,8-15
5,11-15
16,16-15
17,4-75
++END++
++TERMINAL ASSIGNMENTS++
5,3-13,12-13,14-13,16
10,12-11,3-11,5-11,7
++END++
++ENDFILE++

