++LAYOUT++
2 1 1 1 1 1 1 1 1 1 1 2
1 0 0 0 0 0 0 0 0 0 0 1
1 0 0 0 0 0 0 0 0 0 0 1
1 0 0 3 2 2 2 2 3 0 0 1
2 0 0 2 1 1 1 1 2 0 0 1
0 0 0 0 0 1 1 1 2 0 0 1
2 0 0 2 1 1 1 1 2 0 0 1
1 0 0 3 2 2 2 2 3 0 0 1
1 0 0 0 0 0 0 0 0 0 0 1
1 0 0 0 0 0 0 0 0 0 0 1
2 1 1 1 1 1 1 1 1 1 1 2
++END++
++PLACEMENTS++
U R 1 1 1 1 1 1 1 1 R U
R 0 0 0 0 0 0 0 0 E P R
1 E 0 0 0 0 0 0 0 0 0 1
1 0 0 U R 2 2 R U 0 0 1
2 0 0 L 0 1 1 T R 0 0 1
F 0 0 F R 1 1 R 2 0 0 1
2 0 0 L 0 1 1 M R 0 0 1
1 0 0 U R 2 2 R U 0 0 1
1 0 0 0 0 0 0 0 0 0 E 1
R 0 E 0 0 0 0 0 0 0 P R
U R 1 1 1 1 1 1 1 1 R U
++END++
++PATROL ROUTES++
1,2-9,2-9,9-1,9
9,1-9,9-2,9-2,1
10,9-1,9-1,2-10,2
2,10-2,1-9,1-9,10
++END++
++LOOT VALUES++
7,6-90
3,4-15
3,6-15
++END++
++TERMINAL ASSIGNMENTS++
7,4-3,3-3,8-8,3-8,8
++END++
++ENDFILE++

