++LAYOUT++
0 0 0 0 0 0 0 0 0
0 0 0 0 0 0 0 0 0
0 0 0 0 0 0 0 0 0
0 0 0 0 0 - - - -
0 0 0 0 0 - - - -
0 0 0 0 0 - - - -
++END++
++PLACEMENTS++
L - - - F - E - -
- - - - F - - - X
- - - - F - - T -
E - - - - - - - -
- - - - - - - - -
I - - - - - - - -
++END++
++PATROL ROUTES++
0,3-4,3
6,0-8,2
++END++
++LOOT VALUES++
0,0-25
++END++
++ENDFILE++

