++LAYOUT++
0 0 0 0 0 0 0 0 0
0 0 0 0 0 0 0 0 0
0 0 0 0 0 1 1 1 1
0 0 0 0 0 1 1 1 1
0 0 0 0 0 1 1 1 1
0 0 0 0 0 1 1 1 1
++END++
++PLACEMENTS++
- - - - - - E - -
- - - - - R - - X
I - - - - - - - L
E - - - - - - - -
- - - - - U - - -
- - - - - - - - -
++END++
++PATROL ROUTES++
0,3-4,3
6,0-0,0
++END++
++LOOT VALUES++
8,2-20
++END++
++ENDFILE++

