++LAYOUT++
1 1 1 2 2 2 2 2 0 0 0
1 1 1 2 2 2 2 2 0 0 0
1 1 1 2 2 2 2 2 0 0 0
1 1 1 0 0 1 1 1 0 0 0
1 1 1 0 0 1 1 1 0 0 0
1 1 1 0 0 0 0 0 0 0 0
1 1 1 0 0 0 0 0 0 0 0
++END++
++PLACEMENTS++
- - R - - - - - - E P
- - R - - - - - - - E
- - - - - - - - - - -
- - - - L R R - R - -
- - - - - - - - R - -
I - - - - - - - - - X
- - - - - - - - - - -
++END++
++PATROL ROUTES++
10,1-10,6-4,6
9,0-9,5-3,5
++END++
++LOOT VALUES++
4,3-20
++END++
++ENDFILE++

