++LAYOUT++
0 0 0 0 0 0 0 0 0 0 - -
0 0 0 0 0 0 0 0 0 0 - -
0 0 - - - - - 0 0 0 - -
0 0 0 0 0 0 - 0 0 0 0 0
0 0 0 0 0 0 - 0 0 0 0 0
0 0 - - - - - 0 0 0 - -
0 0 0 0 0 0 0 0 0 0 - -
0 0 0 0 0 0 0 0 0 0 - -
++END++
++PLACEMENTS++
0 0 0 0 0 0 F 0 0 0 - -
0 0 0 0 0 0 F 0 0 0 - -
0 0 - - - - - U 0 0 0 -
0 0 0 0 0 P - 0 0 0 0 X
I 0 0 0 0 T - 0 0 H 0 0
0 0 - - - - - U 0 0 0 -
0 0 0 0 0 0 F 0 0 0 - -
0 0 0 0 0 0 F 0 0 0 - -
++END++
++ENDFILE++

