++LAYOUT++
- - - - - - - - - - - - - - - - - - - - - - - - - - - - - -
- - 0 0 0 0 0 0 0 0 0 0 0 0 0 0 0 0 0 0 0 0 0 0 0 0 0 0 0 -
- - 0 0 0 0 0 0 0 0 0 0 0 0 0 0 0 0 0 0 0 0 0 0 0 0 0 0 0 -
- - 0 0 0 - - 0 0 - - 0 0 - - - - - - 0 0 - - 0 0 - - 0 0 -
0 0 0 0 0 - 1 1 1 1 - 0 0 - 1 1 1 1 - 0 0 - 1 1 1 1 - 0 0 -
0 0 0 0 0 - 1 1 1 1 - 0 0 - 1 1 1 1 - 0 0 - 1 1 1 1 - 0 0 -
0 0 0 0 0 - 1 1 1 1 - 0 0 - 1 1 1 1 - 0 0 - 1 1 1 1 - 0 0 -
- - 0 0 0 - - - - - - 0 0 - - 0 0 - - 0 0 - - - - - - 0 0 -
- - 0 0 0 0 0 0 0 0 0 0 0 0 0 0 0 0 0 0 0 0 0 0 0 0 0 0 0 -
- - 0 0 0 0 0 0 0 0 0 0 0 0 0 0 0 0 0 0 0 0 0 0 0 0 0 0 0 -
- - - - - - - - - - - - - - - - - - - - - - - - - - - - - -
++END++
++PLACEMENTS++
- - - - - - - - - - - - - - - - - - - - - - - - - - - - - -
- - H E 0 0 0 0 0 0 0 0 0 0 0 0 0 0 0 0 0 0 0 0 0 0 0 0 0 -
- - 0 0 E 0 0 0 0 0 0 0 0 0 0 0 0 0 0 0 0 0 0 0 0 0 0 0 0 -
- - 0 0 0 - - 0 0 - - 0 0 - - - - - - 0 0 - - 0 0 - - 0 0 -
0 0 0 0 0 - 1 1 1 1 - 0 0 - 1 1 1 U - 0 0 - 1 1 1 1 - 0 0 -
I 0 0 0 0 - 1 1 1 L - 0 0 - 1 1 1 P - 0 0 - 1 1 1 O - 0 0 -
0 0 0 0 0 - 1 1 1 U - 0 0 - 1 1 1 1 - 0 0 - 1 1 1 U - 0 0 -
- - 0 0 0 - - - - - - 0 0 - - 0 0 - - 0 0 - - - - - - 0 0 -
- - 0 0 0 0 0 0 0 0 0 0 0 0 0 0 0 0 0 0 0 0 0 0 0 0 0 E 0 -
- - H 0 0 0 0 0 0 0 0 0 0 0 0 0 0 0 0 0 0 0 0 0 0 0 0 0 E -
- - - - - - - - - - - - - - - - - - - - - - - - - - - - - -
++END++
++PATROL ROUTES++
3,1-11,1-11,8-19,8-19,1-27,1-27,8-19,8-19,1-11,1-11,8-3,8
4,2-12,2-12,9-20,9-20,2-28,2-28,9-20,9-20,2-12,2-12,9-4,9
27,8-19,8-19,1-11,1-11,8-3,8-3,1-11,1-11,8-19,8-19,1-27,1
28,9-20,9-20,2-12,2-12,9-4,9-4,2-12,2-12,9-20,9-20,2-28,2
++END++
++LOOT VALUES++
9,5-20
25,5-80
++END++
++ENDFILE++

