++LAYOUT++
1 1 1 1 1 1 1 1 1 1
1 1 1 1 1 1 1 1 1 1
0 0 0 2 2 2 2 2 2 2
0 0 0 2 2 2 2 2 2 2
0 0 0 2 2 2 2 2 2 2
1 1 1 1 1 1 1 1 1 1
1 1 1 1 1 1 1 1 1 1
++END++
++PLACEMENTS++
- - - - - F E - - -
E - - - - F - - R R
- - R - U - - - - -
I - - - - P - - O -
- - R - U - - - - -
- - - - E F - - R R
- - - - - F - - - E
++END++
++PATROL ROUTES++
4,5-0,5
0,1-4,1
9,6-6,6
6,0-9,0
++END++
++LOOT VALUES++
8,3-75
++END++
++ENDFILE++

