++LAYOUT++
- - - - - - - 0 0 0 0
- - - - - - - 0 0 0 0
0 0 0 0 A A A 0 0 0 0
0 0 0 0 - - - - - - -
0 0 0 0 - - - - - - -
0 0 0 0 a a a 0 0 0 0
- - - - - - - 0 0 0 0
- - - - - - - 0 0 0 0
++END++
++PLACEMENTS++
- - - - - - - 0 0 X 0
- - - - - - - 0 0 0 0
0 0 0 0 A A A 0 0 0 W
I 0 0 0 - - - - - - -
0 0 0 0 - - - - - - -
0 0 0 0 a a a 0 0 0 L
- - - - - - - 0 0 0 0
- - - - - - - 0 0 X 0
++END++
++LOOT VALUES++
10,5-10
++END++
++SWITCH ASSIGNMENTS++
10,2-4,2-5,2-6,2-4,5-5,5-6,5
++END++
++ENDFILE++

