++LAYOUT++
2 2 2 2 2 2 2 - - - 0 0 0 - - - - -
2 2 2 2 2 2 2 - - - 0 0 0 - - - - -
2 2 1 1 1 1 1 - - 2 0 0 0 0 - - - -
2 2 1 1 1 1 1 - - 0 0 0 0 0 - - - - 
2 2 1 0 0 0 0 0 0 0 1 1 1 0 0 0 0 0 
2 2 1 0 0 0 0 0 0 0 1 1 1 0 0 0 0 0 
2 2 1 0 0 0 0 0 0 0 1 1 1 0 0 0 0 0 
2 2 1 1 1 1 1 - - 0 0 0 0 0 - - - -
2 2 1 1 1 1 1 - - 2 0 0 0 0 - - - -
2 2 2 2 2 2 2 - - - 0 0 0 - - - - -
2 2 2 2 2 2 2 - - - 0 0 0 - - - - -
++END++
++PLACEMENTS++
2 2 2 2 2 2 2 - - - 0 X 0 - - - - -
2 2 2 2 2 2 2 - - - 0 0 0 - - - - -
2 2 1 R R R R - - U 0 0 0 H - - - -
2 2 1 1 1 1 1 - - 0 0 0 0 0 - - - - 
2 2 1 0 R R R 0 0 0 1 1 1 0 0 0 0 0 
2 2 1 0 0 0 0 0 0 0 1 T 1 0 0 0 0 X 
2 2 1 0 R R R 0 0 0 1 1 1 0 0 0 0 0 
2 2 1 1 1 1 1 - - 0 0 0 0 0 - - - -
I 2 1 R R R R - - U 0 0 0 H - - - -
2 2 2 2 2 2 2 - - - 0 0 0 - - - - -
2 2 2 2 2 2 2 - - - 0 X 0 - - - - -
++END++
++ENDFILE++

