++LAYOUT++
2 2 2 2 2 2 2 - - - - - - 0 0 0 - 
2 2 2 2 2 2 2 - - - - - - 0 0 0 - 
2 2 1 1 1 1 1 - - - - - - 0 0 0 - 
2 2 1 1 1 1 1 - - - - - - 0 0 0 - 
2 2 1 0 0 0 0 0 0 0 0 0 0 0 0 0 - 
2 2 1 0 0 0 0 0 0 0 0 0 0 0 0 0 - 
2 2 1 0 0 0 0 0 0 0 0 0 0 0 0 0 - 
2 2 1 1 1 1 1 - - - - - - 0 0 0 - 
2 2 1 1 1 1 1 - - - - - - 0 0 0 - 
2 2 2 2 2 2 2 - - - - - - 0 0 0 - 
2 2 2 2 2 2 2 - - - - - - 0 0 0 - 
++END++
++PLACEMENTS++
2 2 2 2 2 2 2 - - - - - - E X 0 - 
2 2 2 2 2 2 2 - - - - - - 0 0 0 - 
2 2 H R R R R - - - - - - 0 0 0 - 
2 2 1 1 1 1 1 - - - - - - 0 0 0 - 
2 2 1 0 R R R 0 0 0 0 0 0 0 0 0 - 
I 2 1 L 0 0 0 0 0 0 0 0 0 0 0 0 - 
2 2 1 0 R R R 0 0 0 0 0 0 0 0 0 - 
2 2 1 1 1 1 1 - - - - - - 0 0 0 - 
2 2 H R R R R - - - - - - 0 0 0 - 
2 2 2 2 2 2 2 - - - - - - 0 0 0 - 
2 2 2 2 2 2 2 - - - - - - E X 0 - 
++END++
++PATROL ROUTES++
13,0-13,4-7,4-13,4
13,10-13,6-7,6-13,6
++END++
++LOOT VALUES++
3,5-10
++END++
++ENDFILE++

