++LAYOUT++
0 0 0 0 0 0 0
0 0 0 0 0 0 0
0 0 1 1 1 0 0
0 0 1 1 1 0 0
0 0 1 1 1 0 0
0 0 0 0 0 0 0
0 0 0 0 0 0 0
++END++
++PLACEMENTS++
- - - X - - -
- - R - R - -
- R - - - R -
X - - S - - X
- R - - - R -
- - R - R - -
- - - X - - -
++END++
++ENDFILE++

