++LAYOUT++
0 0 0 0 1 1 0 0 0 0 0
0 0 0 0 2 1 0 0 0 0 0
0 0 0 0 1 1 0 0 0 0 0
0 0 0 0 2 1 0 0 0 0 0
0 0 0 0 0 0 0 0 0 0 0
0 0 0 0 2 1 0 0 0 0 0
0 0 0 0 1 1 0 0 0 0 0
0 0 0 0 2 1 0 0 0 0 0
0 0 0 0 1 1 0 0 0 0 0
++END++
++PLACEMENTS++
0 0 0 0 1 1 0 0 X 0 0
0 0 0 0 2 1 R 0 0 0 0
0 0 0 0 1 1 0 0 0 0 0
0 0 0 0 2 E 0 0 0 0 0
I 0 0 0 F 0 0 0 0 0 0
0 0 0 0 2 1 0 0 0 0 0
0 0 0 0 1 1 0 0 0 0 0
0 0 0 0 2 1 R 0 0 0 E
0 0 0 0 1 1 0 0 X 0 0
++END++
++PATROL ROUTES++
5,3-8,1
8,7-5,5
++END++
++ENDFILE++

