++LAYOUT++
1 1 1 1 1 1 1 1 1 1 1 1 1 1
2 1 2 1 2 1 2 1 2 1 1 1 1 1
0 0 0 0 0 0 0 0 0 1 1 1 1 1
0 0 0 0 0 0 0 0 0 0 0 0 0 -
0 0 0 0 0 0 0 0 0 0 0 0 0 -
0 0 0 0 0 0 0 0 0 0 0 0 0 -
0 0 0 0 0 0 0 0 0 1 1 1 1 1
2 1 2 1 2 1 2 1 2 1 1 1 1 1
1 1 1 1 1 1 1 1 1 1 1 1 1 1
++END++
++PLACEMENTS++
E 1 1 1 1 1 1 1 1 1 1 X 1 1
2 1 2 1 U 1 2 1 2 1 1 1 1 1
0 0 0 0 0 0 0 0 0 1 1 1 1 1
0 0 0 0 0 0 0 0 0 0 0 R R -
I 0 0 0 0 0 0 0 0 0 0 0 0 -
0 0 0 0 0 0 0 0 0 0 0 R R -
0 0 0 0 0 0 0 0 0 1 1 1 1 1
2 1 2 1 U 1 2 1 2 1 1 1 1 1
1 1 1 1 1 1 1 1 1 1 1 X 1 E
++END++
++PATROL ROUTES++
0,0-13,0
13,8-0,8
++END++
++ENDFILE++

