++LAYOUT++
0 0 0 0 0 1 2 0 0 0
0 0 0 0 0 1 1 0 0 0
0 0 0 0 0 1 2 0 0 0
0 0 0 0 0 1 1 0 0 0
1 1 0 1 1 1 2 0 0 0
1 2 0 2 1 2 1 0 0 0
0 0 0 0 0 0 0 0 0 0
0 0 0 0 0 0 0 0 0 0
0 0 0 0 0 0 0 0 0 0
++END++
++PLACEMENTS++
H 0 0 X 0 1 2 0 0 0
0 0 0 0 0 1 1 0 0 0
0 0 0 0 0 1 U 0 0 0
L 0 0 0 0 1 1 0 0 X
1 1 0 1 1 1 2 0 0 0
1 2 F U 1 2 1 0 0 0
0 0 0 0 0 0 0 0 0 0
I 0 0 0 0 0 0 0 0 0
0 0 0 0 0 0 0 0 0 0
++END++
++PATROL ROUTES++
0,3-4,3
6,0-8,2
++END++
++LOOT VALUES++
0,3-15
++END++
++ENDFILE++

