++LAYOUT++
- - - - 0 0 0 0 0 0 0 0 0 0 0 - - - -
- - - - 0 0 0 0 0 0 0 0 0 0 0 - - - -
- - - - 0 0 0 0 0 0 0 0 0 0 0 - - - -
- - - - 0 0 0 0 0 0 0 0 0 0 0 - - - -
0 0 0 0 2 1 2 1 2 0 2 1 2 1 2 0 0 0 0
0 0 0 0 1 1 1 1 1 1 1 1 1 1 1 0 0 0 0
0 0 0 0 2 1 3 3 0 0 0 3 3 1 2 0 0 0 0
0 0 0 0 1 1 3 3 0 0 0 3 3 1 1 0 0 0 0
0 0 0 0 2 1 0 0 0 0 0 0 0 1 2 0 0 0 0
0 0 0 0 0 1 0 0 0 0 0 0 0 1 0 0 0 0 0
0 0 0 0 2 1 0 0 0 0 0 0 0 1 2 0 0 0 0
0 0 0 0 1 1 3 3 0 0 0 3 3 1 1 0 0 0 0
0 0 0 0 2 1 3 3 0 0 0 3 3 1 2 0 0 0 0
0 0 0 0 1 1 1 1 1 1 1 1 1 1 1 0 0 0 0
0 0 0 0 2 1 2 1 2 0 2 1 2 1 2 0 0 0 0
- - - - 0 0 0 0 0 0 0 0 0 0 0 - - - -
- - - - 0 0 0 0 0 0 0 0 0 0 0 - - - -
- - - - 0 0 0 0 0 0 0 0 0 0 0 - - - -
- - - - 0 0 0 0 0 0 0 0 0 0 0 - - - -
++END++
++PLACEMENTS++
- - - - 0 0 0 0 0 X 0 0 0 0 0 - - - -
- - - - 0 0 0 0 0 0 0 0 0 0 0 - - - -
- - - - 0 0 0 0 0 0 0 0 0 0 0 - - - -
- - - - 0 0 0 0 0 0 0 0 0 0 0 - - - -
0 0 0 0 2 1 2 1 2 R 2 1 2 1 2 0 0 0 0
0 0 0 0 1 L 1 1 1 1 1 1 1 E 1 0 0 0 0
0 0 0 0 2 1 U 3 0 R 0 3 Y 1 2 0 0 0 0
0 0 0 0 1 1 3 3 0 0 0 3 3 1 1 0 0 0 0
0 0 0 0 2 1 0 0 0 0 0 0 0 1 2 0 0 0 0
I 0 0 0 R 1 R 0 0 H 0 0 R 1 R 0 0 0 X
0 0 0 0 2 1 0 0 0 0 0 0 0 1 2 0 0 0 0
0 0 0 0 1 1 3 3 0 0 0 3 3 1 1 0 0 0 0
0 0 0 0 2 1 U 3 0 R 0 3 U 1 2 0 0 0 0
0 0 0 0 1 E 1 1 1 1 1 1 1 L 1 0 0 0 0
0 0 0 0 2 1 2 1 2 R 2 1 2 1 2 0 0 0 0
- - - - 0 0 0 0 0 0 0 0 0 0 0 - - - -
- - - - 0 0 0 0 0 0 0 0 0 0 0 - - - -
- - - - 0 0 0 0 0 0 0 0 0 0 0 - - - -
- - - - 0 0 0 0 0 X 0 0 0 0 0 - - - -
++END++
++PATROL ROUTES++
13,5-5,5-5,13-13,13
5,13-13,13-13,5-5,5
++END++
++LOOT VALUES++
5,6-20
13,2-20
++END++
++ENDFILE++

