++LAYOUT++
0 0 0 0 - - - - - -
0 0 0 0 - - 1 1 1 1
0 0 0 0 - - 1 1 1 1
0 0 0 0 0 0 0 0 1 1
0 0 0 0 0 0 0 0 1 1
0 0 0 0 0 0 0 0 1 1
0 0 0 0 - - 1 1 1 1
0 0 0 0 - - 1 1 1 1
0 0 0 0 - - - - - -
++END++
++PLACEMENTS++
- - - - - - - - - -
- E - - - - P - - E
- - - - - - U - - -
- - - - - F - - - -
I - - - - F - R - -
- - - - - F - - - -
- - - - - - U - - -
- - - E - - L - - -
- - - - - - - - - -
++END++
++PATROL ROUTES++
1,1-1,7
3,7-3,1
9,1-9,7
++END++
++LOOT VALUES++
6,7-80
++END++
++ENDFILE++

