++LAYOUT++
1 1 1 0 0 0 0 0 1 1 1
1 1 1 0 0 0 0 0 1 1 1
1 1 1 0 0 0 0 0 1 1 1
1 1 1 0 0 0 0 0 1 1 1
1 1 1 0 0 0 0 0 1 1 1
1 1 1 0 0 0 0 0 1 1 1
1 1 1 0 0 0 0 0 1 1 1
++END++
++PLACEMENTS++
- - - - - E - - L - -
- - - R - - - - - - -
- - - R - - - - - - -
I - - - - - - - - - X
- - - - - - F R - - -
- - - - - - F R - - -
- - T - - - F - L E -
++END++
++PATROL ROUTES++
5,6-5,0
9,0-9,6
++END++
++LOOT VALUES++
8,0-15
8,6-15
++END++
++ENDFILE++

