++LAYOUT++
0 0 0 0 0 0 0 0 0
0 0 0 0 0 0 0 0 0
0 0 - - 0 - - 0 0
0 0 - - - - - 0 0
0 0 0 0 0 0 0 0 0
0 0 0 0 0 0 0 0 0
++END++
++PLACEMENTS++
- - - - - X - E -
- - - - - - - - E
I - - - P - - - -
- - - - - - - - -
E - - - - U - - X
- E - - - - - - -
++END++
++PATROL ROUTES++
1,5-7,5
7,0-1,0
1,5-4,5
8,1-8,4
++END++
++ENDFILE++

