++LAYOUT++
0 0 0 0 0 0 0
0 0 0 0 0 0 0
0 0 0 0 0 0 0
0 0 0 0 0 0 0
0 0 0 0 0 0 0
0 0 0 0 0 0 0
++END++
++PLACEMENTS++
- - - X - - -
- - - - - - -
- - - - - - -
X - - S - - X
- - - - - - -
- - - - - - -
++END++
++ENDFILE++

