++LAYOUT++
1 1 1 1 1 1 1 - - 0 0 0 - - 0 0 0 0 0 0 0
1 1 1 1 1 1 1 - - 0 0 0 - - 0 0 0 0 0 0 0
0 0 0 0 0 0 0 - - 0 0 - - - 0 0 0 0 1 1 1
0 0 0 0 0 0 0 0 0 0 0 - - - 0 0 0 0 1 1 1
0 0 0 0 0 0 0 0 0 0 0 - - - 0 0 0 0 1 1 1
0 0 0 0 0 0 0 - - 0 0 - - - 0 0 0 0 1 2 2
0 0 0 0 0 0 0 - - 0 0 - - - 0 0 0 0 1 2 2
0 0 0 0 0 0 0 0 - 0 0 0 0 0 0 0 0 0 1 2 2
0 0 0 0 0 0 0 0 - 0 0 0 0 0 0 0 0 0 1 2 2
- - - 0 0 - 0 0 - - - - - - - - - - - - -
0 0 0 0 0 - 0 0 0 0 0 0 0 0 0 - - - - - -
0 0 0 0 0 - 0 0 0 0 0 0 0 0 0 - - - - - -
- - - - - - 0 0 0 0 0 0 0 0 0 - - - - - -
- - - - - - 0 0 0 0 0 0 0 0 0 - - - - - -
- - - - - - 0 0 0 0 0 0 0 0 0 - - - - - -
- - - - - - 0 0 0 0 0 0 0 0 0 - - - - - -
++END++
++PLACEMENTS++
1 1 1 1 1 1 1 - - H 0 L - - 0 0 E 0 E 0 T
1 1 1 1 1 U L - - 0 0 P - - 0 0 0 E 0 0 L
R R 0 0 0 0 0 - - 0 0 - - - 0 0 0 0 0 0 0
0 0 0 H 0 0 0 0 0 0 0 - - - 0 0 0 0 0 0 0
E 0 0 0 0 0 0 0 0 0 0 - - - 0 0 0 0 0 R R
0 0 0 0 0 0 E - - 0 0 - - - 0 0 0 0 0 0 0
0 0 0 0 0 E 0 - - 0 0 - - - 0 0 0 0 0 0 0
0 0 0 0 0 0 0 0 - 0 0 0 0 0 0 0 F R 0 0 0
0 0 0 0 0 0 0 0 - 0 0 0 0 0 0 0 F R 0 P O
- - - 0 0 - 0 0 - - - - - - - - - - - - -
T 0 0 0 0 - 0 0 E 0 E 0 0 0 0 - - - - - -
L 0 0 0 0 - 0 0 0 E 0 0 0 0 0 - - - - - -
- - - - - - 0 0 0 0 0 0 S 0 0 - - - - - -
- - - - - - 0 0 0 0 0 0 0 0 0 - - - - - -
- - - - - - 0 0 0 0 0 0 0 0 0 - - - - - -
- - - - - - H 0 0 0 0 0 0 0 0 - - - - - -
++END++
++PATROL ROUTES++
0,4-6,4
6,5-1,5
5,6-0,6
8,10-8,14
9,11-9,15
10,10-10,14
16,0-16,5
17,1-17,6
18,0-18,8
++END++
++LOOT VALUES++
0,11-25
6,1-20
11,0-15
20,1-20
20,8-125
++END++
++TERMINAL ASSIGNMENTS++
0,10-5,1
20,0-16,7-16,8
++END++
++ENDFILE++

