++LAYOUT++
2 2 2 2 2 2 2 2 2 2 2 2 2 2 2 2 2 2 2 2 2 2 2
2 2 2 2 2 2 2 2 2 2 2 2 2 2 1 1 1 1 1 2 2 2 2
2 2 2 2 2 2 2 2 2 2 2 2 2 1 0 0 0 0 0 1 2 2 2
2 2 2 2 2 2 2 2 2 2 2 2 2 1 0 0 0 0 0 1 2 2 2
2 2 2 2 2 2 2 2 2 2 2 2 2 2 1 0 0 0 1 2 2 2 2
2 2 2 2 1 1 1 1 1 1 1 1 1 1 1 0 0 1 1 1 2 2 2
2 2 2 2 1 1 1 1 1 1 1 1 1 1 1 0 0 1 1 1 2 2 2
2 2 2 1 1 1 1 1 1 1 1 0 0 0 0 0 0 0 0 1 1 1 2
2 2 2 1 1 1 1 1 0 0 0 0 0 0 0 0 0 0 0 0 0 1 2
2 2 2 1 1 1 1 1 1 1 1 0 0 0 0 0 0 0 0 1 1 1 2
2 2 2 2 1 1 1 1 1 1 1 1 1 1 1 0 0 1 1 1 2 2 2
2 2 2 2 1 1 1 1 1 1 1 1 1 1 1 0 0 1 1 1 2 2 2
2 2 2 2 2 2 2 2 2 2 2 2 2 2 1 0 0 0 1 2 2 2 2
2 2 2 2 2 2 2 2 2 2 2 2 2 1 0 0 0 0 0 1 2 2 2
2 2 2 2 2 2 2 2 2 2 2 2 2 1 0 0 0 0 0 1 2 2 2
2 2 2 2 2 2 2 2 2 2 2 2 2 2 1 1 1 1 1 2 2 2 2
2 2 2 2 2 2 2 2 2 2 2 2 2 2 2 2 2 2 2 2 2 2 2
++END++
++PLACEMENTS++
2 2 2 2 2 2 2 2 2 2 2 2 2 2 2 2 2 2 2 2 2 2 2
2 2 2 2 2 2 2 2 2 2 2 2 2 2 1 1 1 1 1 2 2 2 2
2 2 2 2 2 2 2 2 2 2 2 2 2 1 0 0 P O 0 1 2 2 2
2 2 2 2 2 2 2 2 2 2 2 2 2 U 0 0 0 0 0 U 2 2 2
2 2 2 2 2 2 2 2 2 2 2 2 2 2 1 0 0 0 1 2 2 2 2
2 2 2 2 H 1 1 1 1 1 1 1 1 E 1 F F 1 1 1 L 2 2
2 2 2 1 1 1 1 1 1 1 1 1 1 1 E F F 1 1 1 2 2 2
2 2 2 R 1 1 1 1 R R 1 0 0 0 0 0 0 0 0 1 1 1 2
2 2 2 R 1 1 1 1 0 0 0 0 0 0 0 0 0 H 0 0 0 1 2
2 2 2 R 1 1 1 1 R R 1 0 0 0 0 0 0 0 0 1 1 1 2
2 2 2 1 1 1 1 1 1 1 1 1 1 1 1 0 0 1 1 1 2 2 2
2 2 2 2 H 1 1 1 1 1 1 1 1 1 1 0 0 1 1 1 L 2 2
2 2 2 2 2 2 2 2 2 2 2 2 2 2 1 0 0 0 1 2 2 2 2
I 2 2 2 2 2 2 2 2 2 2 2 2 1 0 0 0 0 0 1 2 2 2
2 2 2 2 2 2 2 2 2 2 2 2 2 1 0 0 0 0 T 1 2 2 2
2 2 2 2 2 2 2 2 2 2 2 2 2 2 1 1 1 1 1 2 2 2 2
2 2 2 2 2 2 2 2 2 2 2 2 2 2 2 2 2 2 2 2 2 2 2
++END++
++PATROL ROUTES++
13,5-8,5-8,10-13,10-8,10-8,5
14,6-9,6-9,11-14,11-9,11-9,6
++END++
++TERMINAL ASSIGNEMENTS++
18,14-15,5-15,6-16,5-16,6-13,3-19,3
++END++
++LOOT VALUES++
17,2-70
20,5-15
20,11-15
++END++
++ENDFILE++

