++LAYOUT++
2 2 2 2 2 2 2 2 2 2 2 2 2 2 2 2 2 2 2 2 2 2 2
2 2 2 2 2 2 2 2 2 2 2 2 2 2 2 2 2 2 2 2 2 2 2
2 2 2 2 1 1 1 1 1 1 1 1 1 1 1 1 1 1 1 1 2 2 2
2 2 2 2 1 1 1 1 1 1 1 1 1 1 1 1 1 1 1 1 2 2 2
2 2 2 1 1 1 1 1 1 1 1 0 0 0 0 0 0 0 0 1 1 1 2
2 2 2 1 1 1 1 1 0 0 0 0 0 0 0 0 0 0 0 0 0 1 2
2 2 2 1 1 1 1 1 1 1 1 0 0 0 0 0 0 0 0 1 1 1 2
2 2 2 2 1 1 1 1 1 1 1 1 1 1 1 1 1 1 1 1 2 2 2
2 2 2 2 1 1 1 1 1 1 1 1 1 1 1 1 1 1 1 1 2 2 2
2 2 2 2 2 2 2 2 2 2 2 2 2 2 2 2 2 2 2 2 2 2 2
2 2 2 2 2 2 2 2 2 2 2 2 2 2 2 2 2 2 2 2 2 2 2
++END++
++PLACEMENTS++
2 2 2 2 2 2 2 2 2 2 2 2 2 2 2 2 2 2 2 2 2 2 2
2 2 E 2 2 2 2 2 2 2 2 2 2 2 2 2 2 2 2 2 2 2 2
2 2 2 2 1 R 1 1 1 1 1 R R 1 1 1 1 1 R 1 2 2 2
2 2 2 2 1 1 1 1 1 1 1 1 1 1 1 E 1 1 1 1 2 2 2
2 2 2 1 1 1 1 1 1 1 1 0 R 0 0 0 0 R L 1 1 1 2
I 2 2 1 1 1 1 1 H 0 0 0 0 0 O P 0 0 0 0 H 1 2
2 2 2 1 1 1 1 1 1 1 1 L R 0 0 0 0 R 0 1 1 1 2
2 2 2 2 E 1 1 1 1 1 1 1 1 1 1 1 1 1 1 1 2 2 2
2 2 2 2 1 R 1 1 1 1 1 R R 1 1 1 1 1 R 1 2 2 2
2 2 2 2 2 2 2 2 2 2 2 2 2 2 2 2 2 2 2 2 2 2 E
2 2 2 2 2 2 2 2 2 2 2 2 2 2 2 2 2 2 2 2 2 2 2
++END++
++PATROL ROUTES++
2,1-12,1-22,1-22,9-12,9-2,9
22,9-12,9-2,9-2,1-12,1-22,1
4,7-15,7-21,5-15,3-4,3
15,3-4,3-4,7-15,7-21,5
++END++
++LOOT VALUES++
18,4-15
11,6-15
14,5-65
++END++
++ENDFILE++

