++LAYOUT++
2 2 2 2 2 2 2 2 2 2 2 2 2 2 2 2 2 2 2 2 2 2 2
2 2 2 2 2 2 2 2 2 2 2 2 2 2 2 2 2 2 2 2 2 2 2
2 2 2 2 2 3 3 3 2 2 2 2 2 2 3 3 3 2 2 2 2 2 2
2 2 2 2 3 3 3 3 3 2 2 2 2 3 3 3 3 3 2 2 2 2 2
2 2 2 2 2 2 2 2 2 2 2 2 2 2 2 2 2 2 2 2 2 2 2
2 2 2 2 2 2 1 1 1 1 1 1 1 1 1 1 1 1 1 2 2 2 2
2 2 2 2 2 1 1 1 1 1 1 1 1 1 1 1 1 1 1 1 2 2 2
2 2 2 2 1 1 1 1 1 1 1 0 0 0 0 0 0 0 1 1 1 2 2
2 2 2 1 1 1 1 1 1 1 0 0 0 0 0 0 0 0 0 1 1 1 2
2 2 2 1 1 1 1 1 0 0 0 0 0 0 0 0 0 0 0 0 1 1 2
2 2 2 1 1 1 1 1 1 1 0 0 0 0 0 0 0 0 0 1 1 1 2
2 2 2 2 1 1 1 1 1 1 1 0 0 0 0 0 0 0 1 1 1 2 2
2 2 2 2 2 1 1 1 1 1 1 1 1 1 1 1 1 1 1 1 2 2 2
2 2 2 2 2 2 1 1 1 1 1 1 1 1 1 1 1 1 1 2 2 2 2
2 2 2 2 2 2 2 2 2 2 2 2 2 2 2 2 2 2 2 2 2 2 2
2 2 2 2 3 3 3 3 3 2 2 2 2 3 3 3 3 3 2 2 2 2 2
2 2 2 2 2 3 3 3 2 2 2 2 2 2 3 3 3 2 2 2 2 2 2
2 2 2 2 2 2 2 2 2 2 2 2 2 2 2 2 2 2 2 2 2 2 2
2 2 2 2 2 2 2 2 2 2 2 2 2 2 2 2 2 2 2 2 2 2 2
++END++
++PLACEMENTS++
2 2 2 2 2 2 2 2 2 2 2 2 2 2 2 2 2 2 2 2 2 2 2
2 2 2 2 2 2 R 2 2 2 2 2 2 2 2 R 2 2 2 2 2 2 2
2 2 2 2 2 3 3 3 2 2 2 2 2 2 3 3 3 2 2 2 2 2 2
2 2 2 2 3 3 U 3 3 2 2 2 2 3 3 U 3 3 2 2 2 2 2
I 2 2 2 E 2 2 2 2 2 2 2 2 2 2 2 2 2 2 2 2 2 2
2 2 2 2 2 2 1 1 R R R 1 1 1 R R R 1 1 2 2 2 2
2 2 2 2 2 1 1 1 1 1 1 1 1 1 1 1 1 1 1 1 2 2 2
2 2 2 2 1 1 1 1 1 1 1 0 R R R R R 0 1 1 1 2 2
2 2 2 1 1 1 1 1 1 1 0 0 0 0 0 0 0 0 0 1 1 1 2
2 2 2 1 1 H 1 1 L 0 0 0 0 O 0 0 0 0 0 H 1 P 2
2 2 2 1 1 1 1 1 1 1 0 0 0 0 0 0 0 0 0 1 1 1 2
2 2 2 2 1 1 1 1 1 1 1 0 R R R R R 0 1 1 1 2 2
2 2 2 2 2 1 1 1 1 1 1 1 1 1 1 1 1 1 1 1 2 2 2
2 2 2 2 2 2 1 1 R R R 1 1 1 R R R 1 1 2 2 2 2
2 2 2 2 2 2 2 2 2 2 2 2 2 2 2 2 2 E 2 2 2 2 2
2 2 2 2 3 3 U 3 3 2 2 2 2 3 3 U 3 3 2 2 2 2 2
2 2 2 2 2 3 3 3 2 2 2 2 2 2 3 3 3 2 2 2 2 2 2
2 2 2 2 2 2 R 2 2 2 2 2 2 2 2 R 2 2 2 2 2 2 2
2 2 2 2 2 2 2 2 2 2 2 2 2 2 2 2 2 2 2 2 2 2 2
++END++
++PATROL ROUTES++
4,4-11,4-18,4-22,9-18,14-11,14-4,14-2,9
18,14-11,14-4,14-2,9-4,4-11,4-18,4-22,9
++END++
++LOOT VALUES++
8,9-20
13,9-75
++END++
++ENDFILE++

