++LAYOUT++
0 0 0 0 0 0 0 0 0
0 0 0 0 0 0 0 0 0
0 0 1 1 1 1 1 0 0
0 0 1 1 1 1 1 0 0
0 0 1 1 1 1 1 0 0
0 0 1 1 1 1 1 0 0
++END++
++PLACEMENTS++
- - - - - - - E -
- E - R R R - - -
I - - - - - - - X
- - - - - - - - -
- - - - - - - - -
- - - X - - - E L
++END++
++PATROL ROUTES++
1,1-1,5
7,0-1-0
7,5-7-1
++END++
++LOOT VALUES++
8,5-20
++END++
++ENDFILE++

