++LAYOUT++
0 0 0 0 0 0 0 0 0
0 0 0 0 0 0 0 0 0
0 0 1 1 1 1 1 0 0
0 0 1 1 1 1 1 0 0
0 0 1 1 1 1 1 0 0
0 0 1 1 1 1 1 0 0
++END++
++PLACEMENTS++
- - - - - - - E -
- E - R R R - - -
I - - - - - - - X
- - - - - - - - -
- - - - - - - - -
- - - X - - - E L
++END++
++PATROL ROUTES++
1,4-1,0
7,5-1-5
7,0-7-4
++END++
++LOOT VALUES++
8,0-20
++END++
++ENDFILE++

