++LAYOUT++
1 1 1 2 2 2 2 2 1 1 1
1 1 1 2 2 2 2 2 1 1 1
1 1 1 2 2 2 2 2 1 1 1
1 1 1 - - - - - 1 1 1
1 1 1 - - - - - 1 1 1
1 1 1 0 0 0 0 0 1 1 1
1 1 1 0 0 0 0 0 1 1 1
++END++
++PLACEMENTS++
- - R - - - - T - - L
- - R - - - - E - - -
- - - - - - - L - - -
I - - - - - - - - - X
- - - - - - - - - - -
- - - R F - - R - - -
- - - R F - - R - E -
++END++
++PATROL ROUTES++
7,5-3,5
9,0-9,6
++END++
++LOOT VALUES++
7,3-20
10,6-15
++END++
++ENDFILE++

