++LAYOUT++
1 1 1 1 1 1 1 1 1 1 1
1 1 1 1 1 1 1 1 1 1 1
0 0 0 0 0 0 0 0 0 0 0
0 0 0 0 0 0 0 0 0 0 0
0 0 0 0 0 0 0 0 0 0 0
1 1 1 1 1 1 1 1 1 1 1
1 1 1 1 1 1 1 1 1 1 1
++END++
++PLACEMENTS++
- - - - - - - - L - -
- - - - U U - - - - -
- - - - - - - - - - T
I - - - - - - - - - X
- - - - - - - - - - P
- - - - U U - - - - -
- - - - - - - - L - -
++END++
++LOOT VALUES++
8,0-15
8,6-15
++END++
++ENDFILE++
