++LAYOUT++
1 1 0 0 0 1 1
1 0 0 0 0 0 1
1 0 0 0 0 0 1
1 0 0 0 0 0 1
1 0 0 0 0 0 1
1 0 0 0 0 0 1
1 1 0 0 0 1 1
++END++
++PLACEMENTS++
- - - X - - -
- - - - - - -
- R - - - R -
X - - S - - X
- R - - - R -
- - - - - - -
- - - X - - -
++END++
++ENDFILE++
