++LAYOUT++
1 1 1 1 1 1 1 - - 0 0 0 - - 0 0 0 0 0 0 0 0 0
1 1 1 1 1 1 1 - - 0 0 0 - - 0 0 0 0 0 0 0 0 0
R R 0 0 0 0 0 - - 0 0 - - - 0 0 0 0 0 0 1 1 1
0 0 0 0 0 0 0 0 0 0 0 - - - 0 0 0 0 0 0 1 1 1
0 0 0 0 0 0 0 0 0 0 0 - - - 0 0 0 0 0 0 1 1 1
0 0 0 0 0 0 0 - - 0 0 - - - 0 0 0 0 0 0 1 2 2
0 0 0 0 0 0 0 - - 0 0 - - - 0 0 0 0 0 0 1 2 2
0 0 0 0 0 0 0 0 - 0 0 0 0 0 0 0 0 0 0 0 1 2 2
0 0 0 0 0 0 0 0 - 0 0 0 0 0 0 0 0 0 0 0 1 2 2
- - - 0 0 - 0 0 - - - - - - - - - - - - - - -
- - - 0 0 - 0 0 - - - - - - - - - - - - - - -
- - - 0 0 - 0 0 - - - - - - - - - - - - - - -
- - - 0 0 - 0 0 - - - - - - - - - - - - - - -
0 0 0 0 0 - 0 0 0 0 0 0 0 0 0 0 0 0 0 0 - - -
0 0 0 0 0 - 0 0 0 0 0 0 0 0 0 0 0 0 0 0 - - -
- - - - - - 0 0 0 0 0 0 0 0 0 0 0 0 0 0 - - -
- - - - - - - - 0 0 0 0 0 0 0 0 0 0 0 0 - - -
- - - - - - - - 0 0 0 0 0 0 0 0 0 0 0 0 - - -
- - - - - - - - 0 0 0 0 0 0 0 0 0 0 0 0 - - -
++END++
++PLACEMENTS++
1 1 1 1 1 1 1 - - 0 0 L - - T 0 E 0 E 0 0 0 L
1 1 1 1 1 U L - - 0 0 P - - 0 0 0 E 0 0 0 0 0
R R 0 0 0 0 0 - - 0 0 - - - 0 0 0 0 0 0 1 1 1
0 0 0 0 0 0 0 0 0 0 0 - - - 0 H 0 0 F R 1 1 1
E 0 0 0 0 0 0 0 0 0 0 - - - 0 0 0 0 F R 1 R R
0 0 0 0 0 0 E - - 0 0 - - - 0 0 0 0 0 0 1 2 2
0 0 0 0 0 E 0 - - 0 0 - - - 0 0 0 0 0 0 1 2 2
0 0 0 0 0 0 0 0 - 0 0 0 0 0 0 0 0 0 0 0 1 2 2
0 0 0 0 0 0 0 0 - 0 0 0 0 0 0 0 0 0 0 0 1 P O
- - - 0 0 - 0 0 - - - - - - - - - - - - - - -
- - - 0 0 - 0 0 - - - - - - - - - - - - - - -
- - - 0 0 - 0 0 - - - - - - - - - - - - - - -
- - - 0 0 - 0 0 - - - - - - - - - - - - - - -
T 0 0 0 0 - 0 0 E 0 E 0 0 0 0 0 0 0 0 0 - - -
L 0 0 0 0 - 0 0 0 E 0 0 0 0 0 0 0 0 0 0 - - -
- - - - - - H 0 0 0 0 0 0 0 0 0 0 0 S 0 - - -
- - - - - - - - 0 0 0 0 0 0 0 0 0 0 0 0 - - -
- - - - - - - - 0 0 0 0 0 0 0 0 0 0 0 0 - - -
- - - - - - - - 0 0 0 0 0 0 0 0 0 0 0 0 - - -
++END++
++PATROL ROUTES++
0,4-6,4
6,5-1,5
5,6-0,6
8,13-8,17
9,14-9,18
10,13-10,17
16,0-16,5
17,1-17,6
18,0-18,8
++END++
++LOOT VALUES++
0,14-25
6,1-20
11,0-15
22,0-20
22,8-75
++END++
++TERMINAL ASSIGNMENTS++
0,13-5,1
14,0-18,3-18,4
++END++
++ENDFILE++

